Team,G,MP,FG,FGA,FG%,3P,3PA,3P%,2P,2PA,2P%,FT,FTA,FT%,ORB,DRB,TRB,AST,STL,BLK,TOV,PF,PTS,Year
Cleveland Cavaliers*,82,19930,2803,6083,.461,396,1108,.357,2407,4975,.484,1364,1801,.757,851,2246,3097,1812,556,433,1213,1770,7366,1996
New York Knicks*,82,19780,2800,6410,.437,397,1165,.341,2403,5245,.458,1802,2449,.736,1021,2317,3338,1584,639,324,1264,1907,7799,1996
Atlanta Hawks*,82,19855,3001,6485,.463,420,1212,.347,2581,5273,.489,1394,1919,.726,1051,2391,3442,1733,608,320,1359,1815,7816,1996
Indiana Pacers*,82,19780,2921,6408,.456,475,1304,.364,2446,5104,.479,1516,2089,.726,1048,2156,3204,1804,691,416,1370,2058,7833,1996
Chicago Bulls*,82,19830,2923,6399,.457,401,1150,.349,2522,5249,.480,1682,2280,.738,1068,2252,3320,1713,687,369,1485,1892,7929,1996
Charlotte Hornets*,82,19805,3088,6807,.454,429,1289,.333,2659,5518,.482,1375,1859,.740,1102,2365,3467,1898,535,368,1216,1859,7980,1996
Utah Jazz*,82,19780,2845,6282,.453,546,1431,.382,2299,4851,.474,1835,2477,.741,917,2125,3042,1713,648,429,1353,2053,8071,1996
Sacramento Kings,82,19855,2964,6549,.453,377,1240,.304,2587,5309,.487,1833,2473,.741,1145,2268,3413,1820,756,515,1348,2033,8138,1996
Portland Trail Blazers*,82,19705,2951,6465,.456,442,1189,.372,2509,5276,.476,1794,2380,.754,883,2295,3178,1789,638,405,1302,1938,8138,1996
Philadelphia 76ers,82,19805,3100,6663,.465,467,1287,.363,2633,5376,.490,1569,2057,.763,1143,2317,3460,1992,712,422,1299,1859,8236,1996
Denver Nuggets*,82,19980,3050,6695,.456,419,1208,.347,2631,5487,.479,1721,2296,.750,1021,2207,3228,1784,640,460,1167,1956,8240,1996
San Antonio Spurs*,82,19855,3168,6974,.454,426,1251,.341,2742,5723,.479,1491,2089,.714,1017,2303,3320,1878,633,408,1182,2063,8253,1996
New Jersey Nets,82,19880,3182,6904,.461,440,1176,.374,2742,5728,.479,1495,2073,.721,1056,2435,3491,1826,733,440,1104,1911,8299,1996
Houston Rockets*,82,19730,3202,7061,.453,506,1345,.376,2696,5716,.472,1407,1874,.751,1165,2386,3551,1940,744,365,1274,1779,8317,1996
Seattle SuperSonics*,82,19830,3008,6637,.453,520,1514,.343,2488,5123,.486,1848,2514,.735,1064,2207,3271,1849,652,493,1485,2024,8384,1996
Miami Heat,82,19805,3092,6566,.471,511,1417,.361,2581,5149,.501,1732,2340,.740,1036,2355,3391,1860,656,385,1332,1896,8427,1996
Minnesota Timberwolves,82,19780,3088,6509,.474,468,1243,.377,2620,5266,.498,1820,2491,.731,1169,2305,3474,2069,703,512,1323,1982,8464,1996
Milwaukee Bucks,82,19855,3248,6589,.493,491,1242,.395,2757,5347,.516,1517,2081,.729,1014,2337,3351,2103,770,407,1359,1973,8504,1996
Orlando Magic*,82,19930,3242,7093,.457,468,1239,.378,2774,5854,.474,1560,2106,.741,1136,2226,3362,1986,700,367,1234,1954,8512,1996
Boston Celtics*,82,19805,3303,6820,.484,375,1047,.358,2928,5773,.507,1601,2225,.720,1064,2335,3399,1999,653,454,1232,1922,8582,1996
Los Angeles Lakers*,82,19905,3299,7050,.468,456,1294,.352,2843,5756,.494,1580,2233,.708,1283,2474,3757,2203,644,489,1390,1807,8634,1996
Detroit Pistons,82,19730,3120,6558,.476,448,1235,.363,2672,5323,.502,1963,2720,.722,1147,2432,3579,2013,693,439,1286,1746,8651,1996
Los Angeles Clippers,82,19880,3207,6470,.496,388,1049,.370,2819,5421,.520,1876,2503,.750,1083,2536,3619,1917,693,459,1506,1905,8678,1996
Dallas Mavericks,82,19930,3407,6982,.488,432,1181,.366,2975,5801,.513,1454,1981,.734,1053,2379,3432,1991,722,502,1250,1925,8700,1996
Washington Bullets,82,19855,3246,6768,.480,438,1145,.383,2808,5623,.499,1771,2315,.765,1107,2521,3628,1959,701,446,1359,1775,8701,1996
Phoenix Suns*,82,19830,3320,6963,.477,525,1544,.340,2795,5419,.516,1590,2138,.744,1038,2431,3469,2149,658,391,1285,2026,8755,1996
Golden State Warriors,82,19905,3527,7233,.488,492,1384,.355,3035,5849,.519,1565,2175,.720,1196,2527,3723,2345,865,412,1326,2133,9111,1996
League Average,82,19837,3115,6682,.466,450,1255,.359,2665,5427,.491,1635,2220,.737,1070,2338,3408,1916,679,423,1308,1924,8315,1996
Cleveland Cavaliers*,82,19830,2674,5787,.462,513,1322,.388,2161,4465,.484,1400,1844,.759,874,2167,3041,1818,504,336,1282,1667,7261,1997
Detroit Pistons*,82,19830,2827,6375,.443,505,1380,.366,2322,4995,.465,1458,2039,.715,964,2268,3232,1729,556,385,1153,1887,7617,1997
Chicago Bulls*,82,19730,2880,6428,.448,437,1249,.350,2443,5179,.472,1424,1985,.717,981,2136,3117,1592,595,312,1405,1856,7621,1997
New York Knicks*,82,19830,2859,6471,.442,442,1311,.337,2417,5160,.468,1621,2191,.740,995,2425,3420,1671,653,281,1293,1762,7781,1997
Miami Heat*,82,19780,2734,6303,.434,446,1237,.361,2288,5066,.452,1878,2498,.752,982,2315,3297,1645,662,403,1288,2031,7792,1997
Utah Jazz*,82,19780,2747,6174,.445,550,1428,.385,2197,4746,.463,1820,2422,.751,936,2149,3085,1640,584,409,1284,1983,7864,1997
Indiana Pacers*,82,19755,2841,6291,.452,493,1368,.360,2348,4923,.477,1703,2302,.740,1004,2051,3055,1726,663,420,1259,2041,7878,1997
Seattle SuperSonics*,82,19880,2873,6553,.438,533,1531,.348,2340,5022,.466,1654,2309,.716,1074,2255,3329,1776,758,391,1517,2010,7933,1997
Portland Trail Blazers*,82,19905,2953,6677,.442,472,1355,.348,2481,5322,.466,1574,2127,.740,932,2316,3248,1817,708,409,1192,1996,7952,1997
Atlanta Hawks*,82,19730,3044,6419,.474,479,1329,.360,2565,5090,.504,1392,1865,.746,1054,2292,3346,1841,580,338,1405,1807,7959,1997
San Antonio Spurs*,82,19780,3017,6866,.439,441,1337,.330,2576,5529,.466,1485,2034,.730,1109,2473,3582,1849,604,428,1257,1972,7960,1997
New Jersey Nets,82,19905,3006,6625,.454,543,1415,.384,2463,5210,.473,1476,1994,.740,1028,2355,3383,1876,665,516,1270,1925,8031,1997
Los Angeles Lakers*,82,19680,3118,6806,.458,442,1203,.367,2676,5603,.478,1395,1891,.738,1146,2316,3462,2006,588,483,1334,1806,8073,1997
Orlando Magic*,82,19855,3060,6736,.454,496,1357,.366,2564,5379,.477,1499,2037,.736,1087,2365,3452,1869,644,324,1238,1827,8115,1997
Vancouver Grizzlies,82,19880,3080,6486,.475,459,1226,.374,2621,5260,.498,1561,2129,.733,1102,2550,3652,1988,698,474,1423,1785,8180,1997
Denver Nuggets,82,19830,3091,6741,.459,453,1235,.367,2638,5506,.479,1600,2105,.760,934,2385,3319,1875,617,418,1130,1899,8235,1997
Houston Rockets*,82,19805,3178,6910,.460,482,1344,.359,2696,5566,.484,1423,2012,.707,1126,2499,3625,1945,670,400,1224,1847,8261,1997
Milwaukee Bucks,82,19730,3084,6421,.480,514,1296,.397,2570,5125,.501,1590,2193,.725,998,2305,3303,1940,648,373,1212,1752,8272,1997
Washington Bullets,82,19805,3061,6650,.460,377,1103,.342,2684,5547,.484,1822,2378,.766,1105,2370,3475,1690,696,390,1362,1891,8321,1997
Sacramento Kings*,82,19755,2987,6461,.462,461,1215,.379,2526,5246,.482,1950,2596,.751,1056,2312,3368,1805,767,505,1356,2006,8385,1997
Los Angeles Clippers,82,19730,3090,6471,.478,444,1195,.372,2646,5276,.502,1824,2444,.746,1034,2362,3396,1658,689,401,1357,1860,8448,1997
Golden State Warriors,82,19755,3206,6753,.475,477,1308,.365,2729,5445,.501,1564,2097,.746,1114,2292,3406,2098,698,385,1375,1959,8453,1997
Minnesota Timberwolves,82,19780,3086,6586,.469,530,1393,.380,2556,5193,.492,1761,2368,.744,1036,2317,3353,1966,725,498,1343,1940,8463,1997
Charlotte Hornets,82,19880,3254,6651,.489,530,1340,.396,2724,5311,.513,1440,1957,.736,953,2358,3311,2049,536,368,1215,1829,8478,1997
Phoenix Suns*,82,19955,3217,6837,.471,551,1492,.369,2666,5345,.499,1540,2083,.739,1003,2382,3385,2088,586,420,1191,2011,8525,1997
Philadelphia 76ers,82,19730,3284,6796,.483,526,1421,.370,2758,5375,.513,1472,1986,.741,1164,2478,3642,2109,723,469,1288,1912,8566,1997
Toronto Raptors,82,19830,3146,6624,.475,519,1416,.367,2627,5208,.504,1799,2416,.745,1098,2274,3372,1990,766,482,1326,1739,8610,1997
Boston Celtics,82,19905,3296,6856,.481,415,1162,.357,2881,5694,.506,1767,2366,.747,1040,2590,3630,1916,667,489,1314,1965,8774,1997
Dallas Mavericks,82,19930,3403,6921,.492,470,1193,.394,2933,5728,.512,1535,2097,.732,1087,2726,3813,1978,702,531,1348,1841,8811,1997
League Average,82,19813,3038,6575,.462,483,1316,.367,2555,5259,.486,1601,2164,.740,1035,2348,3383,1860,654,415,1298,1890,8159,1997
Cleveland Cavaliers,82,19855,2488,5638,.441,459,1230,.373,2029,4408,.460,1587,2138,.742,845,2186,3031,1647,549,350,1331,1748,7022,1998
Detroit Pistons*,82,19830,2768,6231,.444,528,1430,.369,2240,4801,.467,1229,1668,.737,964,2264,3228,1795,488,282,1195,1784,7293,1998
Miami Heat*,82,19805,2687,6226,.432,411,1134,.362,2276,5092,.447,1541,2108,.731,999,2321,3320,1512,646,392,1324,1831,7326,1998
Atlanta Hawks*,82,19805,2804,6451,.435,485,1399,.347,2319,5052,.459,1235,1676,.737,1045,2225,3270,1665,605,332,1267,1747,7328,1998
New York Knicks*,82,19855,2665,6272,.425,481,1374,.350,2184,4898,.446,1752,2389,.733,911,2220,3131,1589,727,295,1333,1882,7563,1998
Chicago Bulls*,82,19730,2898,6653,.436,471,1408,.335,2427,5245,.463,1305,1770,.737,1088,2205,3293,1619,624,286,1293,1732,7572,1998
Seattle SuperSonics*,82,19780,2759,6259,.441,613,1644,.373,2146,4615,.465,1513,2042,.741,1015,2256,3271,1751,634,423,1535,1927,7644,1998
Utah Jazz*,82,19830,2708,6188,.438,521,1480,.352,2187,4708,.465,1796,2395,.750,957,2101,3058,1593,639,373,1330,2045,7733,1998
Indiana Pacers,82,19930,2799,6357,.440,499,1440,.347,2300,4917,.468,1642,2182,.753,1004,2261,3265,1737,693,418,1289,1952,7739,1998
Orlando Magic*,82,19855,2966,6450,.460,455,1327,.343,2511,5123,.490,1361,1860,.732,1080,2398,3478,1798,704,417,1314,1769,7748,1998
Portland Trail Blazers*,82,19855,2798,6423,.436,457,1279,.357,2341,5144,.455,1719,2327,.739,952,2197,3149,1703,656,428,1242,1887,7772,1998
Los Angeles Lakers*,82,19930,2922,6619,.441,479,1379,.347,2443,5240,.466,1527,2126,.718,1110,2368,3478,1880,620,388,1341,1934,7850,1998
Houston Rockets*,82,19855,3030,6845,.443,519,1547,.335,2511,5298,.474,1302,1785,.729,1029,2332,3361,1835,731,365,1172,1735,7881,1998
Dallas Mavericks,82,19805,2966,6469,.458,538,1444,.373,2428,5025,.483,1482,1974,.751,1098,2428,3526,1794,687,433,1284,1720,7952,1998
Charlotte Hornets*,82,19805,3056,6650,.460,487,1364,.357,2569,5286,.486,1356,1857,.730,1077,2256,3333,1783,532,335,1143,1781,7955,1998
Milwaukee Bucks,82,19730,2999,6355,.472,369,1080,.342,2630,5275,.499,1606,2197,.731,975,2257,3232,1820,688,392,1201,1777,7973,1998
Minnesota Timberwolves*,82,19780,2945,6539,.450,467,1290,.362,2478,5249,.472,1646,2184,.754,1069,2364,3433,1785,654,445,1283,1829,8003,1998
Washington Bullets*,82,19855,3011,6637,.454,492,1327,.371,2519,5310,.474,1500,2004,.749,1022,2336,3358,1671,665,334,1356,1769,8014,1998
San Antonio Spurs,82,19730,3002,6379,.471,552,1425,.387,2450,4954,.495,1508,2042,.738,1048,2302,3350,1955,664,448,1180,1646,8064,1998
Toronto Raptors,82,19830,2971,6390,.465,497,1427,.348,2474,4963,.498,1646,2274,.724,1033,2352,3385,1967,675,442,1338,1799,8085,1998
Vancouver Grizzlies,82,19780,3092,6556,.472,500,1369,.365,2592,5187,.500,1468,2018,.727,1206,2426,3632,1974,725,461,1251,1593,8152,1998
Los Angeles Clippers*,82,19930,2975,6445,.462,480,1345,.357,2495,5100,.489,1732,2312,.749,1051,2450,3501,1654,737,419,1369,1860,8162,1998
Sacramento Kings,82,19855,3010,6521,.462,442,1254,.352,2568,5267,.488,1723,2337,.737,1063,2341,3404,1777,716,429,1257,1789,8185,1998
New Jersey Nets,82,19780,3100,6684,.464,520,1398,.372,2580,5286,.488,1628,2185,.745,1065,2464,3529,1925,675,516,1257,1780,8348,1998
Phoenix Suns*,82,19855,3183,6818,.467,545,1479,.368,2638,5339,.494,1466,1984,.739,1048,2461,3509,1996,662,372,1298,1840,8377,1998
Denver Nuggets,82,19930,3297,7063,.467,484,1232,.393,2813,5831,.482,1457,1943,.750,1086,2459,3545,1846,724,453,1057,1725,8535,1998
Golden State Warriors,82,19905,3199,6735,.475,581,1558,.373,2618,5177,.506,1578,2103,.750,1089,2272,3361,2159,824,395,1288,1886,8557,1998
Philadelphia 76ers,82,19780,3314,7045,.470,558,1529,.365,2756,5516,.500,1565,2134,.733,1186,2453,3639,2066,822,494,1278,2008,8751,1998
Boston Celtics,82,19905,3365,6696,.503,493,1351,.365,2872,5345,.537,1626,2257,.720,1005,2628,3633,2130,720,557,1446,1827,8849,1998
League Average,82,19833,2958,6503,.455,496,1377,.360,2462,5126,.480,1534,2078,.738,1039,2330,3369,1808,672,403,1285,1814,7946,1998
San Antonio Spurs*,82,19830,2737,6656,.411,338,1029,.328,2399,5627,.426,1448,1956,.740,1017,2236,3253,1556,730,378,1045,1845,7260,1999
New York Knicks*,82,19830,2624,6130,.428,331,1045,.317,2293,5085,.451,1728,2304,.750,854,2341,3195,1585,653,313,1234,1705,7307,1999
Chicago Bulls*,82,19855,2797,6483,.431,329,1022,.322,2468,5461,.452,1425,1956,.729,1016,2239,3255,1595,657,356,1268,1774,7348,1999
Cleveland Cavaliers*,82,19830,2689,6214,.433,341,992,.344,2348,5222,.450,1642,2175,.755,948,2229,3177,1790,707,455,1444,1904,7361,1999
Indiana Pacers*,82,19830,2788,6451,.432,274,867,.316,2514,5584,.450,1525,2096,.728,1114,2254,3368,1591,644,366,1237,1847,7375,1999
Miami Heat*,82,19755,2723,6355,.428,305,921,.331,2418,5434,.445,1632,2195,.744,1058,2232,3290,1630,637,370,1214,1851,7383,1999
Orlando Magic,82,19830,2930,6460,.454,313,967,.324,2617,5493,.476,1302,1769,.736,1089,2268,3357,1740,747,388,1259,1866,7475,1999
Atlanta Hawks*,82,19880,2961,6698,.442,348,1017,.342,2613,5681,.460,1302,1772,.735,1081,2152,3233,1753,617,372,1118,1892,7572,1999
Detroit Pistons,82,19955,2840,6377,.445,363,1100,.330,2477,5277,.469,1549,2077,.746,991,2334,3325,1753,648,382,1263,1874,7592,1999
Portland Trail Blazers*,82,19830,2810,6520,.431,373,1087,.343,2437,5433,.449,1626,2253,.722,1011,2201,3212,1764,770,445,1160,1823,7619,1999
Seattle SuperSonics*,82,19755,2896,6491,.446,417,1287,.324,2479,5204,.476,1449,2001,.724,1141,2314,3455,1825,640,403,1394,1824,7658,1999
Phoenix Suns*,82,19955,2923,6618,.442,394,1091,.361,2529,5527,.458,1501,2051,.732,1051,2343,3394,1803,720,323,1363,1769,7741,1999
Utah Jazz*,82,19780,2806,6390,.439,401,1122,.357,2405,5268,.457,1730,2284,.757,984,2012,2996,1690,645,423,1157,2133,7743,1999
Charlotte Hornets*,82,19780,2977,6417,.464,369,1063,.347,2608,5354,.487,1436,1964,.731,965,2259,3224,1806,582,372,1240,1902,7759,1999
Philadelphia 76ers,82,19755,2906,6440,.451,384,1115,.344,2522,5325,.474,1651,2262,.730,1115,2341,3456,1927,766,508,1318,1904,7847,1999
Milwaukee Bucks,82,19930,2911,6319,.461,304,929,.327,2607,5390,.484,1779,2393,.743,1001,2260,3261,1746,765,398,1348,1808,7905,1999
Washington Wizards,82,19805,2975,6540,.455,348,977,.356,2627,5563,.472,1623,2172,.747,1029,2468,3497,1725,632,372,1328,1924,7921,1999
Golden State Warriors,82,19830,2992,6742,.444,334,962,.347,2658,5780,.460,1667,2286,.729,1134,2535,3669,2011,757,478,1154,1638,7985,1999
Dallas Mavericks,82,19905,3138,6819,.460,386,1130,.342,2752,5689,.484,1333,1868,.714,1223,2644,3867,1882,658,374,1240,1608,7995,1999
Los Angeles Lakers*,82,19830,2984,6800,.439,380,1071,.355,2604,5729,.455,1669,2281,.732,1123,2339,3462,1841,660,423,1281,2151,8017,1999
New Jersey Nets*,82,19880,3016,6406,.471,356,1030,.346,2660,5376,.495,1653,2211,.748,1079,2316,3395,1771,616,515,1482,2023,8041,1999
Boston Celtics,82,19730,2864,5981,.479,299,940,.318,2565,5041,.509,2052,2756,.745,1015,2446,3461,1826,696,406,1688,1719,8079,1999
Sacramento Kings,82,19730,3095,6776,.457,345,968,.356,2750,5808,.473,1560,2102,.742,1157,2533,3690,1824,694,466,1256,1775,8095,1999
Houston Rockets*,82,19830,3173,6769,.469,409,1120,.365,2764,5649,.489,1406,1891,.744,1041,2326,3367,1914,732,365,1170,1747,8161,1999
Minnesota Timberwolves*,82,19930,3076,6860,.448,432,1206,.358,2644,5654,.468,1648,2220,.742,1116,2411,3527,1909,609,412,1228,1863,8232,1999
Denver Nuggets,82,19730,3015,6370,.473,419,1105,.379,2596,5265,.493,1817,2410,.754,1095,2401,3496,1983,662,535,1243,1782,8266,1999
Los Angeles Clippers,82,19780,3236,6832,.474,334,923,.362,2902,5909,.491,1663,2267,.734,1169,2469,3638,1826,726,412,1158,1747,8469,1999
Vancouver Grizzlies,82,19830,3230,6797,.475,428,1111,.385,2802,5686,.493,1634,2233,.732,1146,2356,3502,2101,836,538,1163,1832,8522,1999
Toronto Raptors,82,19930,3271,6826,.479,396,1034,.383,2875,5792,.496,1603,2289,.700,1270,2506,3776,2219,737,514,1370,1748,8541,1999
League Average,82,19832,2944,6536,.450,360,1042,.346,2584,5493,.470,1588,2155,.737,1070,2337,3407,1806,688,416,1270,1837,7837,1999
Atlanta Hawks*,50,12075,1598,3873,.413,190,634,.300,1408,3239,.435,784,1076,.729,581,1369,1950,895,379,243,675,1202,4170,2000
Miami Heat*,50,12025,1565,3805,.411,211,606,.348,1354,3199,.423,860,1167,.737,619,1342,1961,853,387,188,677,1102,4201,2000
San Antonio Spurs*,50,12075,1631,4061,.402,170,559,.304,1461,3502,.417,805,1148,.701,696,1407,2103,941,437,243,730,1148,4237,2000
New York Knicks*,50,12100,1528,3790,.403,234,662,.353,1294,3128,.414,979,1335,.733,616,1426,2042,923,425,215,766,1035,4269,2000
Utah Jazz*,50,12175,1595,3863,.413,214,666,.321,1381,3197,.432,936,1299,.721,635,1294,1929,904,431,264,744,1309,4340,2000
Orlando Magic*,50,12050,1708,3856,.443,230,667,.345,1478,3189,.463,697,986,.707,595,1424,2019,1039,468,239,863,1111,4343,2000
Detroit Pistons*,50,12050,1585,3639,.436,236,682,.346,1349,2957,.456,941,1317,.715,548,1377,1925,1043,424,225,770,1113,4347,2000
Philadelphia 76ers*,50,12150,1599,3784,.423,241,716,.337,1358,3068,.443,941,1288,.731,619,1402,2021,999,435,263,896,1185,4380,2000
Cleveland Cavaliers,50,12050,1597,3664,.436,236,675,.350,1361,2989,.455,978,1316,.743,591,1405,1996,1056,392,282,821,1198,4408,2000
Portland Trail Blazers*,50,12175,1644,3939,.417,220,691,.318,1424,3248,.438,916,1263,.725,616,1388,2004,962,411,244,785,1142,4424,2000
Milwaukee Bucks*,50,12050,1600,3746,.427,272,814,.334,1328,2932,.453,1029,1369,.752,657,1398,2055,1018,399,194,830,1020,4501,2000
Golden State Warriors,50,12125,1617,3848,.420,193,575,.336,1424,3273,.435,1114,1531,.728,656,1503,2159,1023,400,304,735,1027,4541,2000
Indiana Pacers*,50,12100,1706,3935,.434,206,634,.325,1500,3301,.454,928,1227,.756,626,1426,2052,955,357,238,652,1127,4546,2000
Chicago Bulls,50,12075,1723,3786,.455,208,612,.340,1515,3174,.477,914,1247,.733,551,1568,2119,1099,444,285,782,1074,4568,2000
Houston Rockets*,50,12075,1793,4136,.434,230,645,.357,1563,3491,.448,779,1062,.734,664,1391,2055,1034,441,245,653,1030,4595,2000
Minnesota Timberwolves*,50,12025,1680,3823,.439,213,654,.326,1467,3169,.463,1055,1470,.718,591,1563,2154,1114,363,262,836,1017,4628,2000
Toronto Raptors,50,12075,1694,3855,.439,255,686,.372,1439,3169,.454,996,1368,.728,614,1393,2007,1095,446,258,773,1088,4639,2000
Charlotte Hornets,50,12150,1739,4003,.434,212,637,.333,1527,3366,.454,959,1306,.734,655,1491,2146,1092,443,232,762,1151,4649,2000
Phoenix Suns*,50,12050,1772,3936,.450,272,755,.360,1500,3181,.472,850,1224,.694,614,1506,2120,1064,410,205,812,1065,4666,2000
Washington Wizards,50,12050,1705,3826,.446,218,619,.352,1487,3207,.464,1044,1418,.736,617,1517,2134,1079,402,212,792,1087,4672,2000
Dallas Mavericks,50,12075,1815,4037,.450,216,686,.315,1599,3351,.477,855,1193,.717,660,1519,2179,1073,361,244,699,1042,4701,2000
Boston Celtics,50,12150,1725,3896,.443,175,561,.312,1550,3335,.465,1118,1506,.742,642,1544,2186,1018,461,253,841,1001,4743,2000
New Jersey Nets,50,12050,1796,3968,.453,223,654,.341,1573,3314,.475,943,1298,.727,624,1581,2205,968,395,326,813,1084,4758,2000
Seattle SuperSonics,50,12100,1838,4026,.457,264,765,.345,1574,3261,.483,857,1187,.722,652,1446,2098,1111,399,224,746,1165,4797,2000
Los Angeles Lakers*,50,12050,1759,3992,.441,217,653,.332,1542,3339,.462,1064,1501,.709,628,1403,2031,1062,408,196,716,1271,4799,2000
Vancouver Grizzlies,50,12175,1813,3917,.463,229,653,.351,1584,3264,.485,1021,1400,.729,673,1456,2129,1189,490,328,779,1165,4876,2000
Los Angeles Clippers,50,12125,1830,3858,.474,222,627,.354,1608,3231,.498,1078,1445,.746,640,1506,2146,1101,419,289,782,1042,4960,2000
Denver Nuggets,50,12025,1885,4017,.469,237,640,.370,1648,3377,.488,997,1339,.745,620,1502,2122,1175,396,274,701,1103,5004,2000
Sacramento Kings*,50,12200,2009,4500,.446,219,652,.336,1790,3848,.465,793,1113,.712,750,1598,2348,1165,490,221,790,1102,5030,2000
League Average,50,12091,1709,3910,.437,223,658,.339,1486,3252,.457,939,1290,.728,629,1453,2083,1036,418,248,766,1111,4579,2000
San Antonio Spurs*,82,19855,2884,6781,.425,355,1036,.343,2529,5745,.440,1276,1726,.739,986,2410,3396,1667,645,429,1181,1893,7399,2001
New York Knicks*,82,19830,2711,6398,.424,404,1197,.338,2307,5201,.444,1609,2153,.747,927,2441,3368,1609,603,354,1161,1799,7435,2001
Portland Trail Blazers*,82,19780,2825,6557,.431,394,1195,.330,2431,5362,.453,1422,1985,.716,978,2220,3198,1705,652,350,1186,1872,7466,2001
Miami Heat*,82,19830,2782,6595,.422,408,1130,.361,2374,5465,.434,1512,2022,.748,974,2341,3315,1582,621,364,1150,1795,7484,2001
Utah Jazz*,82,19755,2781,6240,.446,388,1097,.354,2393,5143,.465,1598,2141,.746,887,2236,3123,1620,588,411,1270,2023,7548,2001
Los Angeles Lakers*,82,19805,2838,6824,.416,372,1142,.326,2466,5682,.434,1518,2045,.742,1007,2531,3538,1597,627,345,1196,2099,7566,2001
Philadelphia 76ers*,82,19830,2867,6595,.435,417,1172,.356,2450,5423,.452,1510,2001,.755,1065,2501,3566,1828,631,531,1444,1977,7661,2001
Phoenix Suns*,82,19805,2825,6665,.424,403,1146,.352,2422,5519,.439,1630,2205,.739,1071,2465,3536,1700,733,427,1422,1794,7683,2001
Chicago Bulls,82,19805,2916,6396,.456,358,1049,.341,2558,5347,.478,1533,2070,.741,1000,2416,3416,1902,853,461,1244,1966,7723,2001
Charlotte Hornets*,82,19780,3048,6811,.448,410,1086,.378,2638,5725,.461,1347,1807,.745,966,2550,3516,1903,604,421,1297,2076,7853,2001
Minnesota Timberwolves*,82,19905,2924,6576,.445,380,1066,.356,2544,5510,.462,1644,2185,.752,916,2440,3356,1737,591,344,1232,1685,7872,2001
Indiana Pacers*,82,19730,3113,6982,.446,329,1006,.327,2784,5976,.466,1374,1821,.755,1040,2545,3585,1735,610,323,1126,1910,7929,2001
Toronto Raptors*,82,19755,3002,6615,.454,346,1021,.339,2656,5594,.475,1631,2136,.764,961,2552,3513,1790,557,434,1250,1874,7981,2001
Seattle SuperSonics*,82,19780,3132,6941,.451,440,1293,.340,2692,5648,.477,1343,1795,.748,1084,2611,3695,1939,590,433,1258,1839,8047,2001
New Jersey Nets,82,19830,3125,6741,.464,368,1013,.363,2757,5728,.481,1503,2012,.747,1129,2657,3786,1866,568,469,1366,1869,8121,2001
Orlando Magic,82,19755,3076,6919,.445,431,1277,.338,2645,5642,.469,1567,2104,.745,1094,2473,3567,1991,724,475,1488,2008,8150,2001
Vancouver Grizzlies,82,19855,3136,6613,.474,361,1083,.333,2775,5530,.502,1530,1989,.769,970,2336,3306,1932,725,519,1234,1912,8163,2001
Atlanta Hawks,82,19830,3211,7060,.455,373,1015,.367,2838,6045,.469,1381,1796,.769,1052,2474,3526,1886,655,404,1001,1830,8176,2001
Washington Wizards,82,19805,3005,6547,.459,390,1052,.371,2615,5495,.476,1790,2405,.744,962,2418,3380,1793,686,503,1225,1967,8190,2001
Boston Celtics,82,19730,2960,6304,.470,359,995,.361,2601,5309,.490,1929,2563,.753,857,2534,3391,1798,638,473,1395,1928,8208,2001
Houston Rockets,82,19830,3226,7074,.456,350,990,.354,2876,6084,.473,1425,1829,.779,1027,2451,3478,1863,735,433,1126,1833,8227,2001
Cleveland Cavaliers,82,19855,2983,6736,.443,420,1229,.342,2563,5507,.465,1851,2385,.776,1013,2586,3599,1942,659,500,1389,2058,8237,2001
Milwaukee Bucks*,82,19855,3033,6644,.457,531,1357,.391,2502,5287,.473,1685,2241,.752,1037,2368,3405,1987,637,340,1303,1870,8282,2001
Denver Nuggets,82,19855,3129,6953,.450,399,1126,.354,2730,5827,.469,1632,2174,.751,1027,2606,3633,2003,616,462,1179,1937,8289,2001
Dallas Mavericks,82,19730,3225,7053,.457,429,1244,.345,2796,5809,.481,1484,2005,.740,1251,2719,3970,1901,604,416,1318,1814,8363,2001
Detroit Pistons*,82,19830,3119,6706,.465,458,1234,.371,2661,5472,.486,1669,2237,.746,973,2504,3477,1893,652,396,1400,2219,8365,2001
Sacramento Kings*,82,19805,3269,7239,.452,396,1123,.353,2873,6116,.470,1434,1910,.751,1143,2761,3904,1950,753,404,1437,1943,8368,2001
Los Angeles Clippers,82,19705,3281,6879,.477,417,1077,.387,2864,5802,.494,1512,2041,.741,1038,2699,3737,1975,621,377,1172,1731,8491,2001
Golden State Warriors,82,19755,3165,6776,.467,427,1163,.367,2738,5613,.488,1755,2328,.754,1091,2691,3782,2036,690,495,1338,1887,8512,2001
League Average,82,19802,3020,6732,.449,397,1125,.353,2623,5607,.468,1555,2073,.750,1018,2501,3519,1832,651,424,1269,1911,7993,2001
New York Knicks*,82,19905,2568,6159,.417,445,1266,.352,2123,4893,.434,1478,2015,.733,872,2418,3290,1573,596,338,1216,1754,7059,2002
Miami Heat*,82,19880,2701,6261,.431,360,1087,.331,2341,5174,.452,1339,1818,.737,914,2528,3442,1421,598,424,1275,1824,7101,2002
San Antonio Spurs*,82,19830,2837,6770,.419,343,1043,.329,2494,5727,.435,1233,1664,.741,967,2432,3399,1617,600,426,1107,1946,7250,2002
Charlotte Hornets*,82,19880,2767,6501,.426,389,1081,.360,2378,5420,.439,1444,1910,.756,892,2436,3328,1748,616,375,1204,1768,7367,2002
Philadelphia 76ers*,82,19855,2871,6699,.429,427,1248,.342,2444,5451,.448,1243,1660,.749,985,2366,3351,1771,672,458,1261,1938,7412,2002
Portland Trail Blazers*,82,19780,2819,6436,.438,406,1103,.368,2413,5333,.452,1436,1930,.744,946,2238,3184,1745,646,324,1216,1738,7480,2002
Phoenix Suns*,82,19805,2792,6422,.435,327,937,.349,2465,5485,.449,1618,2127,.761,902,2588,3490,1652,682,416,1433,1819,7529,2002
Utah Jazz*,82,19780,2667,6076,.439,410,1194,.343,2257,4882,.462,1830,2391,.765,874,2183,3057,1564,699,453,1320,2007,7574,2002
Indiana Pacers*,82,19980,2829,6683,.423,377,1121,.336,2452,5562,.441,1572,2074,.758,1042,2495,3537,1695,589,387,1115,1882,7607,2002
Houston Rockets,82,19830,3020,6733,.449,359,1015,.354,2661,5718,.465,1385,1862,.744,988,2420,3408,1735,605,400,1092,1771,7784,2002
Los Angeles Clippers,82,20030,2995,6800,.440,354,1075,.329,2641,5725,.461,1474,1983,.743,1042,2439,3481,1791,638,412,1045,1795,7818,2002
Toronto Raptors*,82,19955,3009,6725,.447,379,1045,.363,2630,5680,.463,1425,1890,.754,926,2511,3437,1696,561,439,1156,1792,7822,2002
Sacramento Kings*,82,20080,3087,7139,.432,401,1131,.355,2686,6008,.447,1291,1724,.749,1121,2643,3764,1816,666,476,1334,1766,7866,2002
Minnesota Timberwolves*,82,19830,2977,6588,.452,350,996,.351,2627,5592,.470,1567,2164,.724,967,2505,3472,1834,583,357,1246,1655,7871,2002
Atlanta Hawks,82,19730,2922,6609,.442,396,1080,.367,2526,5529,.457,1646,2153,.765,1029,2534,3563,1737,698,513,1212,1696,7886,2002
Dallas Mavericks*,82,19805,2938,6693,.439,381,1140,.334,2557,5553,.460,1631,2231,.731,1068,2623,3691,1778,622,379,1273,1848,7888,2002
Cleveland Cavaliers,82,19830,2927,6582,.445,422,1155,.365,2505,5427,.462,1633,2125,.768,990,2400,3390,1880,694,542,1229,1810,7909,2002
Orlando Magic*,82,19955,2830,6499,.435,366,1059,.346,2464,5440,.453,1885,2566,.735,1061,2609,3670,1793,695,440,1408,1946,7911,2002
Chicago Bulls,82,19855,2987,6330,.472,346,973,.356,2641,5357,.493,1607,2202,.730,957,2551,3508,1932,635,426,1217,1754,7927,2002
Boston Celtics,82,19830,2935,6392,.459,430,1170,.368,2505,5222,.480,1634,2178,.750,888,2650,3538,1885,650,440,1402,1903,7934,2002
Milwaukee Bucks*,82,19780,2912,6626,.439,439,1246,.352,2473,5380,.460,1679,2186,.768,1014,2490,3504,1883,592,350,1273,1778,7942,2002
New Jersey Nets,82,19730,2937,6452,.455,428,1189,.360,2509,5263,.477,1664,2231,.746,1001,2622,3623,1840,619,522,1304,1808,7966,2002
Los Angeles Lakers*,82,19905,2983,6815,.438,413,1168,.354,2570,5647,.455,1595,2114,.754,981,2407,3388,1659,619,324,1073,2002,7974,2002
Seattle SuperSonics,82,19805,3076,6783,.453,471,1351,.349,2605,5432,.480,1353,1824,.742,1046,2431,3477,1957,648,510,1228,1816,7976,2002
Detroit Pistons,82,19855,2976,6850,.434,428,1229,.348,2548,5621,.453,1596,2169,.736,1012,2671,3683,1860,669,397,1274,2062,7976,2002
Vancouver Grizzlies,82,19780,3143,6791,.463,389,1075,.362,2754,5716,.482,1317,1798,.732,1052,2534,3586,1935,710,476,1217,1768,7992,2002
Denver Nuggets,82,19780,3081,6914,.446,416,1168,.356,2665,5746,.464,1542,2049,.753,1012,2642,3654,2042,588,497,1075,1758,8120,2002
Washington Wizards,82,19680,3100,6596,.470,433,1093,.396,2667,5503,.485,1559,2088,.747,931,2410,3341,1902,688,511,1230,1974,8192,2002
Golden State Warriors,82,19780,3179,6740,.472,439,1159,.379,2740,5581,.491,1529,2011,.760,1039,2693,3732,2045,722,493,1348,1765,8326,2002
League Average,82,19846,2926,6609,.443,397,1124,.354,2529,5485,.461,1524,2039,.748,983,2499,3482,1786,641,431,1234,1833,7774,2002
Miami Heat,82,19930,2666,6279,.425,379,1109,.342,2287,5170,.442,1565,2127,.736,894,2484,3378,1461,620,353,1134,1709,7276,2003
Philadelphia 76ers*,82,19730,2771,6500,.426,438,1322,.331,2333,5178,.451,1350,1798,.751,981,2348,3329,1768,654,458,1208,1827,7330,2003
San Antonio Spurs*,82,19855,2883,6775,.426,374,1108,.338,2509,5667,.443,1283,1651,.777,1003,2429,3432,1543,635,428,1192,1896,7423,2003
Toronto Raptors*,82,19755,2820,6390,.441,377,1089,.346,2443,5301,.461,1513,2011,.752,995,2436,3431,1629,628,393,1250,1612,7530,2003
New Jersey Nets*,82,19830,2858,6668,.429,409,1175,.348,2449,5493,.446,1423,1890,.753,999,2517,3516,1563,669,439,1317,1667,7548,2003
Detroit Pistons*,82,19680,2926,6546,.447,359,993,.362,2567,5553,.462,1349,1787,.755,991,2511,3502,1638,651,335,1273,1874,7560,2003
Charlotte Hornets*,82,19755,2850,6594,.432,433,1156,.375,2417,5438,.444,1488,1938,.768,963,2399,3362,1639,625,422,1140,1703,7621,2003
Portland Trail Blazers*,82,19830,2951,6508,.453,466,1285,.363,2485,5223,.476,1312,1771,.741,890,2328,3218,1945,612,410,1208,1651,7680,2003
Boston Celtics*,82,19830,2797,6579,.425,514,1511,.340,2283,5068,.450,1612,2091,.771,954,2807,3761,1802,623,476,1335,1734,7720,2003
Los Angeles Lakers*,82,19780,2872,6777,.424,399,1259,.317,2473,5518,.448,1577,2072,.761,1016,2526,3542,1643,587,354,1148,1890,7720,2003
Washington Wizards,82,19730,2953,6534,.452,422,1191,.354,2531,5343,.474,1396,1849,.755,960,2376,3336,1818,573,414,1095,1713,7724,2003
Seattle SuperSonics*,82,19830,2966,6605,.449,472,1374,.344,2494,5231,.477,1362,1844,.739,1091,2326,3417,1832,568,400,1254,1627,7766,2003
Utah Jazz*,82,19830,2777,6218,.447,465,1215,.383,2312,5003,.462,1779,2308,.771,927,2204,3131,1585,748,548,1371,2069,7798,2003
New York Knicks,82,19805,2924,6570,.445,443,1256,.353,2481,5314,.467,1550,2047,.757,959,2540,3499,1762,686,385,1103,1670,7841,2003
Phoenix Suns,82,19830,2957,6663,.444,433,1208,.358,2524,5455,.463,1511,2013,.751,1030,2493,3523,1821,685,475,1265,1521,7858,2003
Minnesota Timberwolves*,82,19805,2962,6654,.445,492,1321,.372,2470,5333,.463,1452,1958,.742,912,2326,3238,1855,542,407,1097,1676,7868,2003
Los Angeles Clippers,82,19805,3074,6866,.448,407,1145,.355,2667,5721,.466,1329,1783,.745,1064,2379,3443,1859,612,439,1055,1775,7884,2003
Indiana Pacers*,82,19905,2977,6800,.438,418,1200,.348,2559,5600,.457,1544,2062,.749,1048,2514,3562,1771,618,466,1173,1855,7916,2003
Sacramento Kings*,82,19755,3128,7108,.440,386,1145,.337,2742,5963,.460,1312,1764,.744,1065,2617,3682,1839,633,387,1246,1827,7954,2003
Houston Rockets,82,19980,3191,6875,.464,370,1028,.360,2821,5847,.482,1221,1623,.752,1045,2507,3552,1838,576,415,988,1647,7973,2003
Memphis Grizzlies,82,19780,3119,6829,.457,398,1112,.358,2721,5717,.476,1346,1788,.753,1135,2560,3695,1961,781,457,1207,1784,7982,2003
Milwaukee Bucks,82,19905,3016,6846,.441,493,1377,.358,2523,5469,.461,1489,1967,.757,1050,2438,3488,1883,599,361,1054,1642,8014,2003
Chicago Bulls,82,19805,3027,6514,.465,421,1177,.358,2606,5337,.488,1560,2090,.746,944,2553,3497,2066,681,399,1178,1720,8035,2003
Denver Nuggets,82,19805,3005,6540,.459,424,1173,.361,2581,5367,.481,1602,2144,.747,995,2529,3524,1968,671,560,1173,1646,8036,2003
Atlanta Hawks,82,19780,3065,6675,.459,472,1329,.355,2593,5346,.485,1456,1957,.744,1004,2523,3527,1856,705,509,1239,1647,8058,2003
Cleveland Cavaliers,82,19855,3053,6678,.457,473,1200,.394,2580,5478,.471,1506,2014,.748,928,2382,3310,1989,602,459,1063,1638,8085,2003
Orlando Magic*,82,19830,3116,6828,.456,409,1161,.352,2707,5667,.478,1470,1994,.737,1086,2633,3719,1930,659,384,1292,1740,8111,2003
Dallas Mavericks*,82,19880,3094,6851,.452,452,1293,.350,2642,5558,.475,1640,2184,.751,1065,2600,3665,1865,589,377,1155,1788,8280,2003
Golden State Warriors,82,19780,3213,6993,.459,404,1162,.348,2809,5831,.482,1622,2125,.763,1100,2450,3550,2002,706,512,1176,1949,8452,2003
League Average,82,19816,2966,6664,.445,428,1209,.354,2538,5455,.465,1470,1953,.752,1003,2474,3477,1798,639,428,1186,1741,7829,2003
Detroit Pistons*,82,19905,2744,6269,.438,289,839,.344,2455,5430,.452,1413,1895,.746,859,2528,3387,1501,568,355,1149,1904,7190,2004
New Jersey Nets*,82,19755,2757,6461,.427,425,1185,.359,2332,5276,.442,1453,1941,.749,932,2461,3393,1607,693,423,1358,1880,7392,2004
San Antonio Spurs*,82,19830,2862,6703,.427,354,1043,.339,2508,5660,.443,1334,1737,.768,1029,2322,3351,1559,665,422,1231,1915,7412,2004
Miami Heat,82,19830,2713,6208,.437,406,1149,.353,2307,5059,.456,1598,2129,.751,872,2587,3459,1482,626,436,1173,1671,7430,2004
New Orleans Hornets*,82,19905,2857,6518,.438,338,1001,.338,2519,5517,.457,1474,1925,.766,909,2368,3277,1630,647,427,1196,1754,7526,2004
Seattle SuperSonics,82,19855,2871,6424,.447,472,1371,.344,2399,5053,.475,1351,1821,.742,938,2462,3400,1703,500,409,1209,1671,7565,2004
Utah Jazz*,82,19780,2751,6346,.434,437,1252,.349,2314,5094,.454,1627,2143,.759,1011,2120,3131,1601,723,427,1305,1950,7566,2004
Houston Rockets,82,19930,2891,6681,.433,386,1113,.347,2505,5568,.450,1399,1805,.775,979,2353,3332,1683,663,381,1082,1794,7567,2004
Denver Nuggets,82,19730,2696,6087,.443,420,1134,.370,2276,4953,.460,1768,2337,.757,861,2443,3304,1764,742,538,1405,1789,7580,2004
Washington Wizards,82,19830,2877,6507,.442,449,1242,.362,2428,5265,.461,1382,1792,.771,949,2447,3396,1776,612,358,1171,1804,7585,2004
Portland Trail Blazers*,82,19855,2942,6540,.450,438,1285,.341,2504,5255,.476,1267,1659,.764,912,2292,3204,1863,683,391,1270,1670,7589,2004
Boston Celtics*,82,19830,2804,6450,.435,463,1400,.331,2341,5050,.464,1560,2084,.749,937,2750,3687,1824,617,367,1315,1798,7631,2004
Indiana Pacers*,82,19905,2860,6690,.428,407,1197,.340,2453,5493,.447,1527,1992,.767,1006,2458,3464,1696,620,513,1258,1923,7654,2004
Phoenix Suns*,82,19805,2913,6658,.438,436,1361,.320,2477,5297,.468,1479,1932,.766,1031,2487,3518,1824,639,453,1309,1763,7741,2004
Philadelphia 76ers*,82,19855,2876,6363,.452,453,1278,.354,2423,5085,.476,1547,2035,.760,908,2400,3308,1809,639,521,1405,1885,7752,2004
Dallas Mavericks*,82,19780,2926,6687,.438,477,1401,.340,2449,5286,.463,1477,2032,.727,1045,2682,3727,1781,547,322,1316,1746,7806,2004
Sacramento Kings*,82,19830,2991,7125,.420,373,1166,.320,2618,5959,.439,1454,1962,.741,1145,2614,3759,1759,684,356,1262,1635,7809,2004
Minnesota Timberwolves*,82,19805,3005,6873,.437,472,1362,.347,2533,5511,.460,1394,1853,.752,974,2444,3418,1871,571,405,1116,1686,7876,2004
Toronto Raptors,82,19805,3037,6592,.461,370,986,.375,2667,5606,.476,1490,1964,.759,976,2601,3577,1729,604,406,1125,1702,7934,2004
New York Knicks,82,19855,2961,6478,.457,358,1053,.340,2603,5425,.480,1691,2193,.771,935,2613,3548,1732,627,308,1179,1631,7971,2004
Atlanta Hawks,82,19905,3015,6907,.437,446,1243,.359,2569,5664,.454,1530,2013,.760,1073,2420,3493,1771,738,409,1068,1668,8006,2004
Los Angeles Clippers,82,19755,3035,6787,.447,454,1244,.365,2581,5543,.466,1507,1946,.774,1046,2460,3506,1840,652,418,1152,1844,8031,2004
Los Angeles Lakers*,82,19930,2976,6725,.443,465,1223,.380,2511,5502,.456,1622,2133,.760,957,2495,3452,1753,644,311,1190,1916,8039,2004
Orlando Magic*,82,19805,3007,6602,.455,405,1211,.334,2602,5391,.483,1648,2150,.767,970,2596,3566,1837,643,411,1341,1823,8067,2004
Milwaukee Bucks*,82,19905,3043,6642,.458,479,1278,.375,2564,5364,.478,1574,2114,.745,1021,2541,3562,1892,543,333,1182,1685,8139,2004
Chicago Bulls,82,19930,2991,6817,.439,431,1333,.323,2560,5484,.467,1794,2394,.749,1117,2572,3689,1949,768,413,1208,1796,8207,2004
Memphis Grizzlies,82,19930,3224,7008,.460,431,1188,.363,2793,5820,.480,1381,1819,.759,1126,2555,3681,1991,714,430,1213,1782,8260,2004
Cleveland Cavaliers,82,19830,3072,6786,.453,428,1197,.358,2644,5589,.473,1712,2219,.772,932,2491,3423,1972,802,494,1162,1709,8284,2004
Golden State Warriors,82,19755,3240,7175,.452,438,1177,.372,2802,5998,.467,1575,2084,.756,1204,2388,3592,1934,710,491,1121,1936,8493,2004
League Average,82,19842,2929,6624,.442,421,1204,.349,2508,5421,.463,1518,2004,.758,988,2481,3469,1763,651,411,1223,1784,7797,2004
San Antonio Spurs*,82,19755,2613,6388,.409,311,951,.327,2302,5437,.423,1372,1844,.744,909,2459,3368,1419,635,380,1254,1837,6909,2005
Detroit Pistons*,82,19780,2633,6378,.413,356,1180,.302,2277,5198,.438,1287,1730,.744,980,2353,3333,1561,649,410,1310,1877,6909,2005
Indiana Pacers*,82,19805,2671,6180,.432,329,1014,.324,2342,5166,.453,1350,1800,.750,867,2423,3290,1649,582,512,1301,1794,7021,2005
New Jersey Nets*,82,19705,2693,6302,.427,418,1193,.350,2275,5109,.445,1392,1830,.761,873,2471,3344,1627,656,374,1321,1739,7196,2005
Houston Rockets*,82,19930,2636,6405,.412,457,1227,.372,2179,5178,.421,1491,2024,.737,907,2351,3258,1689,710,359,1103,1695,7220,2005
Toronto Raptors,82,19980,2722,6365,.428,273,889,.307,2449,5476,.447,1536,2055,.747,1034,2662,3696,1518,590,333,1196,1619,7253,2005
Minnesota Timberwolves*,82,19755,2741,6625,.414,395,1181,.334,2346,5444,.431,1426,1893,.753,1001,2400,3401,1701,547,296,1106,1656,7303,2005
Miami Heat*,82,19755,2658,6205,.428,431,1256,.343,2227,4949,.450,1612,2100,.768,892,2486,3378,1526,578,439,1207,1729,7359,2005
Utah Jazz,82,19780,2541,5879,.432,415,1209,.343,2126,4670,.455,1874,2431,.771,868,2131,2999,1528,666,530,1262,1999,7371,2005
Philadelphia 76ers,82,19855,2751,6369,.432,443,1329,.333,2308,5040,.458,1474,1982,.744,996,2398,3394,1747,678,463,1245,1757,7419,2005
New Orleans Hornets*,82,19830,2843,6443,.441,444,1301,.341,2399,5142,.467,1407,1877,.750,972,2477,3449,1790,613,429,1282,1734,7537,2005
Portland Trail Blazers,82,19980,2954,6567,.450,417,1222,.341,2537,5345,.475,1219,1618,.753,1016,2292,3308,1912,657,390,1120,1534,7544,2005
New York Knicks*,82,19880,2785,6491,.429,415,1228,.338,2370,5263,.450,1678,2198,.763,950,2444,3394,1676,675,383,1132,1600,7663,2005
Golden State Warriors,82,19855,2948,6630,.445,414,1107,.374,2534,5523,.459,1399,1875,.746,981,2532,3513,1762,666,418,1145,1801,7709,2005
Memphis Grizzlies*,82,19880,2859,6550,.436,369,1091,.338,2490,5459,.456,1643,2150,.764,1099,2508,3607,1674,673,461,1395,1891,7730,2005
Los Angeles Lakers*,82,19855,2920,6640,.440,420,1247,.337,2500,5393,.464,1472,1964,.749,922,2558,3480,1708,616,308,1254,2024,7732,2005
Cleveland Cavaliers,82,19855,2956,6759,.437,431,1162,.371,2525,5597,.451,1491,1990,.749,971,2475,3446,1783,635,434,1071,1656,7834,2005
Chicago Bulls,82,19830,2882,6611,.436,439,1235,.355,2443,5376,.454,1673,2238,.748,1011,2682,3693,1890,694,446,1250,1684,7876,2005
Denver Nuggets*,82,19730,3019,6662,.453,376,1056,.356,2643,5606,.471,1470,2020,.728,1056,2465,3521,1931,664,479,1399,1895,7884,2005
Boston Celtics*,82,19705,2894,6626,.437,555,1534,.362,2339,5092,.459,1587,2157,.736,1069,2524,3593,1882,719,408,1406,1819,7930,2005
Milwaukee Bucks*,82,19780,3034,6719,.452,456,1296,.352,2578,5423,.475,1428,1932,.739,983,2521,3504,1870,615,406,1164,1878,7952,2005
Washington Wizards,82,19830,3061,6740,.454,424,1238,.342,2637,5502,.479,1444,1874,.771,1048,2520,3568,1966,786,448,1321,1783,7990,2005
Atlanta Hawks,82,19905,2968,6740,.440,482,1345,.358,2486,5395,.461,1574,2072,.760,1048,2485,3533,1803,731,416,1151,1699,7992,2005
Seattle SuperSonics,82,19805,2980,6622,.450,486,1394,.349,2494,5228,.477,1570,2028,.774,1068,2430,3498,1728,629,387,1211,1658,8016,2005
Sacramento Kings*,82,19780,3140,6920,.454,409,1205,.339,2731,5715,.478,1333,1780,.749,1080,2521,3601,1743,651,413,1225,1817,8022,2005
Phoenix Suns,82,19730,2975,6671,.446,479,1374,.349,2496,5297,.471,1601,2092,.765,1038,2550,3588,1760,649,431,1304,1589,8030,2005
Los Angeles Clippers,82,19805,3075,6687,.460,452,1256,.360,2623,5431,.483,1545,2086,.741,1033,2358,3391,1874,693,437,1122,1861,8147,2005
Dallas Mavericks*,82,19805,3133,6824,.459,534,1471,.363,2599,5353,.486,1462,1960,.746,1009,2562,3571,1937,582,382,1242,1690,8262,2005
Orlando Magic,82,19830,3169,6804,.466,491,1301,.377,2678,5503,.487,1458,1964,.742,1072,2570,3642,2004,625,450,1111,1691,8287,2005
League Average,82,19820,2871,6545,.439,425,1224,.347,2446,5321,.460,1492,1985,.752,991,2469,3461,1747,650,415,1228,1759,7659,2005
San Antonio Spurs*,82,19805,2712,6359,.426,323,881,.367,2389,5478,.436,1501,1955,.768,893,2403,3296,1385,594,421,1240,1891,7248,2006
Detroit Pistons*,82,19955,2791,6496,.430,410,1213,.338,2381,5283,.451,1344,1790,.751,928,2321,3249,1618,610,367,1135,1851,7336,2006
Houston Rockets*,82,19855,2720,6423,.423,454,1343,.338,2266,5080,.446,1571,2116,.742,892,2444,3336,1696,607,335,1087,1773,7465,2006
Memphis Grizzlies*,82,19705,2684,6215,.432,426,1215,.351,2258,5000,.452,1679,2179,.771,993,2387,3380,1633,612,476,1303,1853,7473,2006
Indiana Pacers*,82,19905,2768,6284,.440,391,1071,.365,2377,5213,.456,1637,2202,.743,972,2416,3388,1540,549,398,1142,1883,7564,2006
New Jersey Nets*,82,19905,2710,6167,.439,485,1319,.368,2225,4848,.459,1714,2304,.744,874,2503,3377,1666,601,402,1283,1881,7619,2006
Chicago Bulls*,82,19830,2763,6548,.422,416,1245,.334,2347,5303,.443,1716,2305,.744,979,2524,3503,1715,685,434,1272,1914,7658,2006
Miami Heat*,82,19980,2865,6705,.427,441,1269,.348,2424,5436,.446,1621,2134,.760,922,2397,3319,1620,611,264,1085,2020,7792,2006
Minnesota Timberwolves,82,19755,2967,6777,.438,468,1291,.363,2499,5486,.456,1413,1880,.752,1032,2359,3391,1783,540,323,963,1629,7815,2006
New Orleans Hornets,82,19930,2847,6299,.452,494,1346,.367,2353,4953,.475,1644,2122,.775,947,2485,3432,1742,634,452,1168,1728,7832,2006
Cleveland Cavaliers,82,19855,2913,6444,.452,422,1122,.376,2491,5322,.468,1601,2135,.750,938,2324,3262,1737,549,419,1213,1770,7849,2006
Los Angeles Clippers,82,20030,2936,6618,.444,485,1317,.368,2451,5301,.462,1555,2041,.762,986,2255,3241,1732,638,393,1122,1934,7912,2006
Seattle SuperSonics*,82,19755,2932,6382,.459,470,1317,.357,2462,5065,.486,1591,2124,.749,930,2174,3104,1698,508,390,1085,1949,7925,2006
Dallas Mavericks*,82,19730,2941,6712,.438,451,1366,.330,2490,5346,.466,1601,2123,.754,1072,2467,3539,1714,584,399,1278,1899,7934,2006
Portland Trail Blazers,82,19730,3056,6842,.447,440,1283,.343,2616,5559,.471,1397,1851,.755,1149,2312,3461,1923,700,414,1102,1670,7949,2006
Utah Jazz,82,19780,2731,5965,.458,486,1297,.375,2245,4668,.481,2027,2653,.764,859,2230,3089,1592,646,474,1182,2058,7975,2006
Denver Nuggets*,82,19755,2950,6606,.447,463,1342,.345,2487,5264,.472,1632,2189,.746,975,2441,3416,1778,636,458,1342,1960,7995,2006
New York Knicks,82,19880,3001,6454,.465,464,1276,.364,2537,5178,.490,1711,2264,.756,969,2448,3417,1697,602,389,1195,1736,8177,2006
Philadelphia 76ers*,82,19855,2930,6618,.443,565,1560,.362,2365,5058,.468,1764,2299,.767,952,2663,3615,1878,681,383,1394,1929,8189,2006
Milwaukee Bucks,82,19780,3098,6678,.464,463,1349,.343,2635,5329,.494,1559,2022,.771,935,2413,3348,1953,611,370,1067,1953,8218,2006
Charlotte Bobcats,82,19880,3015,6507,.463,442,1224,.361,2573,5283,.487,1748,2279,.767,959,2586,3545,1768,624,446,1297,1858,8220,2006
Boston Celtics*,82,19880,2960,6664,.444,488,1370,.356,2472,5294,.467,1825,2423,.753,1039,2427,3466,1859,714,402,1277,1937,8233,2006
Washington Wizards*,82,19780,3099,6748,.459,521,1432,.364,2578,5316,.485,1549,2034,.762,1017,2510,3527,1885,586,412,1306,1995,8268,2006
Golden State Warriors,82,19905,3133,6838,.458,450,1239,.363,2683,5599,.479,1555,2087,.745,1057,2771,3828,1858,570,417,1257,1782,8271,2006
Toronto Raptors,82,19805,3133,6708,.467,435,1222,.356,2698,5486,.492,1610,2165,.744,991,2720,3711,1814,507,360,1182,1795,8311,2006
Sacramento Kings*,82,19855,3186,6941,.459,471,1318,.357,2715,5623,.483,1485,2011,.738,1102,2532,3634,1766,622,365,1204,1762,8328,2006
Los Angeles Lakers,82,19780,3141,6928,.453,549,1522,.361,2592,5406,.479,1507,1931,.780,1023,2453,3476,2001,627,420,965,1814,8338,2006
Orlando Magic,82,19705,3081,6826,.451,443,1291,.343,2638,5535,.477,1739,2306,.754,1024,2428,3452,1747,698,354,1190,1920,8344,2006
Atlanta Hawks,82,19855,3044,6389,.476,467,1232,.379,2577,5157,.500,1846,2396,.770,902,2483,3385,1803,716,484,1210,1777,8401,2006
Phoenix Suns*,82,19780,3328,7485,.445,494,1476,.335,2834,6009,.472,1320,1775,.744,1233,2550,3783,1741,627,342,1131,1750,8470,2006
League Average,82,19833,2948,6588,.447,459,1292,.356,2489,5296,.470,1615,2137,.756,985,2448,3432,1745,616,399,1189,1856,7970,2006
Memphis Grizzlies*,82,19855,2691,6172,.436,408,1223,.334,2283,4949,.461,1465,1942,.754,927,2404,3331,1605,597,456,1213,1867,7255,2007
San Antonio Spurs*,82,19805,2782,6420,.433,300,886,.339,2482,5534,.449,1414,1912,.740,886,2417,3303,1336,599,343,1136,1709,7278,2007
Detroit Pistons*,82,19830,2915,6450,.452,329,1012,.325,2586,5438,.476,1235,1677,.736,951,2399,3350,1541,481,285,1145,1726,7394,2007
Houston Rockets,82,19830,2708,6310,.429,541,1465,.369,2167,4845,.447,1560,2135,.731,874,2477,3351,1647,582,373,1094,1716,7517,2007
Indiana Pacers*,82,19730,2831,6504,.435,371,1083,.343,2460,5421,.454,1511,2060,.733,968,2416,3384,1520,661,399,1112,1800,7544,2007
New Jersey Nets*,82,19780,2730,6222,.439,465,1336,.348,2265,4886,.464,1654,2232,.741,787,2599,3386,1641,589,329,1177,1889,7579,2007
Dallas Mavericks*,82,19880,2801,6319,.443,404,1120,.361,2397,5199,.461,1626,2163,.752,935,2209,3144,1433,536,400,1151,1958,7632,2007
Minnesota Timberwolves,82,19855,2852,6474,.441,447,1229,.364,2405,5245,.459,1525,2072,.736,974,2411,3385,1554,539,374,1139,1736,7676,2007
Utah Jazz,82,19880,2730,6077,.449,490,1297,.378,2240,4780,.469,1839,2466,.746,871,2237,3108,1511,663,463,1166,2104,7789,2007
Cleveland Cavaliers*,82,19830,2949,6481,.455,459,1291,.356,2490,5190,.480,1462,1970,.742,807,2421,3228,1666,540,357,1079,1842,7819,2007
Los Angeles Clippers*,82,19805,2887,6638,.435,474,1367,.347,2413,5271,.458,1593,2175,.732,858,2432,3290,1765,570,355,1053,1777,7841,2007
New Orleans/Oklahoma City Hornets,82,19805,2883,6286,.459,546,1486,.367,2337,4800,.487,1530,2014,.760,860,2498,3358,1584,527,432,1197,1910,7842,2007
Orlando Magic,82,19905,2870,6327,.454,460,1287,.357,2410,5040,.478,1672,2285,.732,911,2239,3150,1644,615,386,1099,1899,7872,2007
Miami Heat*,82,19755,2871,6529,.440,490,1359,.361,2381,5170,.461,1642,2223,.739,826,2359,3185,1596,560,298,1063,1938,7874,2007
Los Angeles Lakers*,82,19855,2945,6547,.450,474,1342,.353,2471,5205,.475,1585,2123,.747,893,2399,3292,1730,536,354,1158,1925,7949,2007
Chicago Bulls*,82,19905,2773,6515,.426,501,1428,.351,2272,5087,.447,1921,2472,.777,881,2541,3422,1652,611,420,1228,1883,7968,2007
Sacramento Kings*,82,19830,3053,6726,.454,462,1316,.351,2591,5410,.479,1412,1891,.747,953,2503,3456,1733,656,403,1199,1886,7980,2007
Portland Trail Blazers,82,19730,3032,6472,.468,498,1306,.381,2534,5166,.491,1498,1971,.760,1029,2445,3474,1737,592,403,1060,1704,8060,2007
Milwaukee Bucks*,82,19855,2972,6383,.466,490,1385,.354,2482,4998,.497,1671,2237,.747,832,2475,3307,1847,606,414,1182,1937,8105,2007
Boston Celtics,82,19880,2944,6462,.456,446,1265,.353,2498,5197,.481,1825,2457,.743,910,2369,3279,1763,688,404,1210,1837,8159,2007
Washington Wizards*,82,19830,3014,6477,.465,501,1379,.363,2513,5098,.493,1655,2222,.745,964,2477,3441,1766,537,341,1326,2075,8184,2007
Golden State Warriors,82,19830,3047,6674,.457,469,1335,.351,2578,5339,.483,1624,2187,.743,985,2662,3647,1828,576,409,1258,1919,8187,2007
Denver Nuggets*,82,19930,3070,6764,.454,530,1480,.358,2540,5284,.481,1538,2090,.736,965,2469,3434,1959,586,436,1323,1911,8208,2007
Charlotte Bobcats,82,19905,3065,6410,.478,458,1285,.356,2607,5125,.509,1683,2283,.737,940,2667,3607,1881,577,441,1464,1929,8271,2007
Philadelphia 76ers,82,19905,3100,6699,.463,498,1420,.351,2602,5279,.493,1609,2111,.762,974,2533,3507,1882,630,386,1269,1898,8307,2007
Atlanta Hawks,82,19880,3075,6433,.478,444,1205,.368,2631,5228,.503,1768,2372,.745,981,2335,3316,1689,597,422,1227,1855,8362,2007
New York Knicks,82,19930,2967,6359,.467,565,1495,.378,2402,4864,.494,1868,2480,.753,883,2280,3163,1744,674,437,1154,2079,8367,2007
Phoenix Suns*,82,19955,3243,7141,.454,516,1423,.363,2727,5718,.477,1429,1956,.731,1028,2735,3763,1546,591,282,1218,1623,8431,2007
Toronto Raptors,82,19955,3164,6448,.491,508,1363,.373,2656,5085,.522,1696,2267,.748,835,2539,3374,1938,518,359,1165,1834,8532,2007
Seattle SuperSonics,82,19830,3202,6596,.485,542,1445,.375,2660,5151,.516,1713,2255,.760,1003,2316,3319,1973,598,399,1194,1820,8659,2007
League Average,82,19852,2939,6477,.454,470,1310,.358,2469,5167,.478,1607,2157,.745,916,2442,3358,1690,588,385,1182,1866,7955,2007
San Antonio Spurs*,82,19780,2860,6463,.443,368,1101,.334,2492,5362,.465,1300,1756,.740,829,2379,3208,1416,580,337,1176,1739,7388,2008
Detroit Pistons*,82,19880,2819,6337,.445,409,1205,.339,2410,5132,.470,1484,2006,.740,973,2403,3376,1647,521,290,1205,1668,7531,2008
Houston Rockets*,82,19855,2793,6503,.429,472,1346,.351,2321,5157,.450,1497,2000,.749,800,2548,3348,1588,571,353,1163,1631,7555,2008
Dallas Mavericks*,82,19755,2790,6241,.447,375,1074,.349,2415,5167,.467,1654,2216,.746,839,2286,3125,1471,565,312,1190,1811,7609,2008
Cleveland Cavaliers*,82,19880,2838,6337,.448,405,1231,.329,2433,5106,.476,1539,2096,.734,807,2461,3268,1649,540,349,1254,1804,7620,2008
Chicago Bulls*,82,19780,2793,6416,.435,484,1387,.349,2309,5029,.459,1619,2219,.730,897,2456,3353,1675,614,433,1429,1900,7689,2008
Orlando Magic*,82,19780,2739,6191,.442,461,1306,.353,2278,4885,.466,1768,2327,.760,865,2217,3082,1609,678,376,1232,1921,7707,2008
Miami Heat*,82,19855,2895,6517,.444,531,1495,.355,2364,5022,.471,1513,2039,.742,921,2467,3388,1656,562,314,1185,1790,7834,2008
Los Angeles Clippers,82,19730,2912,6436,.452,455,1341,.339,2457,5095,.482,1602,2142,.748,843,2377,3220,1722,582,321,1132,1829,7881,2008
New Orleans/Oklahoma City Hornets,82,19880,3004,6579,.457,559,1575,.355,2445,5004,.489,1395,1839,.759,853,2493,3346,1703,554,392,1119,1733,7962,2008
Philadelphia 76ers,82,19880,3039,6570,.463,503,1424,.353,2536,5146,.493,1452,1926,.754,969,2404,3373,1825,606,320,1280,1801,8033,2008
Indiana Pacers,82,19780,2931,6416,.457,437,1175,.372,2494,5241,.476,1741,2311,.753,915,2499,3414,1642,644,410,1289,1942,8040,2008
New Jersey Nets*,82,19880,2911,6476,.450,519,1455,.357,2392,5021,.476,1723,2261,.762,867,2526,3393,1805,584,369,1188,1886,8064,2008
Portland Trail Blazers,82,19955,2962,6292,.471,467,1293,.361,2495,4999,.499,1678,2157,.778,850,2347,3197,1703,539,380,1127,1750,8069,2008
Atlanta Hawks,82,19880,2953,6335,.466,465,1236,.376,2488,5099,.488,1699,2315,.734,948,2370,3318,1732,597,421,1247,1853,8070,2008
Toronto Raptors*,82,19755,3051,6593,.463,533,1491,.357,2518,5102,.494,1441,1911,.754,848,2641,3489,1742,489,317,1241,1786,8076,2008
Utah Jazz*,82,19805,2819,6191,.455,506,1424,.355,2313,4767,.485,1943,2534,.767,813,2223,3036,1552,623,438,1230,2010,8087,2008
Boston Celtics,82,19855,2966,6337,.468,429,1212,.354,2537,5125,.495,1776,2376,.747,848,2476,3324,1811,604,449,1250,1757,8137,2008
Minnesota Timberwolves,82,20005,3075,6689,.460,518,1488,.348,2557,5201,.492,1510,1987,.760,957,2438,3395,1782,583,360,1163,1679,8178,2008
New York Knicks,82,20005,3021,6566,.460,573,1523,.376,2448,5043,.485,1613,2135,.756,885,2297,3182,1748,616,406,1122,1875,8228,2008
Charlotte Bobcats,82,20005,2999,6450,.465,452,1245,.363,2547,5205,.489,1802,2404,.750,929,2562,3491,1717,603,437,1296,1786,8252,2008
Seattle SuperSonics,82,19830,3126,6568,.476,519,1437,.361,2607,5131,.508,1596,2124,.751,954,2408,3362,1870,590,341,1233,1635,8367,2008
Phoenix Suns*,82,19905,3238,7087,.457,504,1387,.363,2734,5700,.480,1458,1901,.767,1008,2504,3512,1548,566,304,1242,1759,8438,2008
Sacramento Kings,82,19805,3147,6671,.472,557,1524,.365,2590,5147,.503,1600,2115,.757,907,2648,3555,1840,572,405,1335,1990,8451,2008
Los Angeles Lakers*,82,20030,3097,6719,.461,523,1462,.358,2574,5257,.490,1763,2320,.760,955,2508,3463,1798,649,409,1208,1916,8480,2008
Denver Nuggets*,82,19780,3257,7088,.460,554,1569,.353,2703,5519,.490,1438,1945,.739,1006,2461,3467,2010,680,424,1343,1946,8506,2008
Milwaukee Bucks,82,19855,3201,6673,.480,565,1537,.368,2636,5136,.513,1564,2109,.742,1062,2468,3530,2077,615,433,1284,1718,8531,2008
Washington Wizards*,82,19830,3166,6700,.473,598,1585,.377,2568,5115,.502,1668,2146,.777,973,2551,3524,1942,519,380,1291,1927,8598,2008
Memphis Grizzlies,82,19980,3287,6761,.486,576,1480,.389,2711,5281,.513,1603,2113,.759,965,2483,3448,2062,681,450,1253,1992,8753,2008
Golden State Warriors*,82,19755,3171,6871,.462,609,1664,.366,2562,5207,.492,1814,2419,.750,1074,2733,3807,2023,680,399,1525,1832,8765,2008
League Average,82,19858,2995,6536,.458,498,1389,.358,2498,5147,.485,1608,2138,.752,912,2454,3366,1746,594,378,1241,1822,8097,2008
Detroit Pistons*,82,19730,2727,6239,.437,409,1233,.332,2318,5006,.463,1523,2047,.744,865,2344,3209,1563,477,319,1108,1618,7386,2009
Boston Celtics*,82,19755,2657,6341,.419,485,1535,.316,2172,4806,.452,1605,2160,.743,899,2290,3189,1539,594,389,1308,1818,7404,2009
San Antonio Spurs*,82,19730,2857,6431,.444,420,1227,.342,2437,5204,.468,1293,1710,.756,776,2527,3303,1490,566,361,1058,1625,7427,2009
Houston Rockets*,82,19730,2852,6594,.433,433,1186,.365,2419,5408,.447,1410,1912,.737,894,2441,3335,1548,622,379,1094,1615,7547,2009
New Orleans Hornets*,82,19805,3038,6604,.460,544,1552,.351,2494,5052,.494,1217,1579,.771,815,2533,3348,1779,470,331,1136,1573,7837,2009
Dallas Mavericks*,82,19730,2903,6551,.443,408,1168,.349,2495,5383,.463,1648,2168,.760,882,2419,3301,1547,536,357,999,1739,7862,2009
Philadelphia 76ers*,82,19755,3000,6504,.461,557,1549,.360,2443,4955,.493,1332,1726,.772,923,2293,3216,1903,550,420,1289,1708,7889,2009
Portland Trail Blazers,82,19905,2983,6616,.451,533,1499,.356,2450,5117,.479,1401,1828,.766,957,2465,3422,1714,488,301,1026,1656,7900,2009
Cleveland Cavaliers*,82,19855,2939,6462,.455,506,1419,.357,2433,5043,.482,1548,2070,.748,814,2500,3314,1721,559,388,1092,1666,7932,2009
Toronto Raptors*,82,19830,3007,6569,.458,619,1683,.368,2388,4886,.489,1344,1732,.776,830,2583,3413,1797,470,333,1149,1508,7977,2009
Orlando Magic*,82,19780,3057,6855,.446,516,1441,.358,2541,5414,.469,1489,1975,.754,900,2519,3419,1764,581,344,1081,1898,8119,2009
Washington Wizards*,82,19905,3015,6537,.461,683,1768,.386,2332,4769,.489,1418,1880,.754,900,2478,3378,1958,529,360,1149,1656,8131,2009
Utah Jazz*,82,19705,2896,6286,.461,506,1419,.357,2390,4867,.491,1848,2468,.749,844,2256,3100,1629,619,420,1305,1891,8146,2009
Miami Heat,82,19830,3029,6477,.468,552,1497,.369,2477,4980,.497,1590,2105,.755,916,2617,3533,1817,631,341,1166,1650,8200,2009
Atlanta Hawks*,82,19855,3115,6733,.463,512,1413,.362,2603,5320,.489,1461,1943,.752,968,2386,3354,1825,615,421,1123,1793,8203,2009
Chicago Bulls,82,19805,2982,6583,.453,571,1522,.375,2411,5061,.476,1699,2217,.766,914,2582,3496,1794,648,465,1254,1746,8234,2009
New Jersey Nets,82,19830,2982,6543,.456,534,1448,.369,2448,5095,.480,1774,2311,.768,896,2517,3413,1810,662,362,1098,1836,8272,2009
Los Angeles Clippers,82,19805,3114,6670,.467,486,1393,.349,2628,5277,.498,1574,2096,.751,916,2657,3573,1834,590,388,1112,1773,8288,2009
Los Angeles Lakers*,82,19780,3127,7022,.445,554,1531,.362,2573,5491,.469,1501,1995,.752,988,2521,3509,1793,634,368,1168,1850,8309,2009
Charlotte Bobcats,82,19880,3115,6684,.466,517,1456,.355,2598,5228,.497,1571,2102,.747,999,2588,3587,1785,625,476,1177,1721,8318,2009
Minnesota Timberwolves,82,19730,3056,6481,.472,541,1516,.357,2515,4965,.507,1742,2266,.769,871,2545,3416,1899,610,467,1103,1434,8395,2009
New York Knicks,82,19880,3184,6711,.474,587,1592,.369,2597,5119,.507,1535,2078,.739,924,2573,3497,1773,621,429,1046,1665,8490,2009
Milwaukee Bucks,82,19855,3147,6562,.480,588,1530,.384,2559,5032,.509,1639,2141,.766,872,2464,3336,1913,647,404,1125,1727,8521,2009
Sacramento Kings,82,19830,3137,6732,.466,597,1600,.373,2540,5132,.495,1722,2287,.753,970,2465,3435,1878,661,452,1250,1892,8593,2009
Phoenix Suns*,82,19780,3368,7384,.456,469,1329,.353,2899,6055,.479,1407,1879,.749,1101,2498,3599,1607,601,311,1101,1731,8612,2009
Indiana Pacers,82,19755,3093,6817,.454,606,1571,.386,2487,5246,.474,1850,2443,.757,929,2800,3729,1820,663,416,1297,1782,8642,2009
Seattle SuperSonics,82,19830,3288,7136,.461,607,1576,.385,2681,5560,.482,1534,2048,.749,961,2655,3616,1997,706,440,1082,1610,8717,2009
Memphis Grizzlies,82,19805,3394,7076,.480,591,1625,.364,2803,5451,.514,1387,1791,.774,932,2721,3653,1963,711,403,1096,1842,8766,2009
Denver Nuggets*,82,19855,3334,7303,.457,621,1710,.363,2713,5593,.485,1481,2028,.730,1042,2680,3722,2107,644,393,1343,1950,8770,2009
Golden State Warriors,82,19780,3273,6998,.468,572,1556,.368,2701,5442,.496,1806,2378,.759,1053,2803,3856,1939,567,413,1384,1736,8924,2009
League Average,82,19803,3056,6683,.457,537,1485,.362,2518,5199,.484,1545,2045,.755,918,2524,3442,1784,597,388,1157,1724,8194,2009
Cleveland Cavaliers*,82,19780,2775,6444,.431,482,1447,.333,2293,4997,.459,1459,1895,.770,878,2310,3188,1568,519,338,1137,1664,7491,2010
San Antonio Spurs*,82,19905,2973,6568,.453,447,1180,.379,2526,5388,.469,1257,1635,.769,745,2570,3315,1481,531,352,961,1511,7650,2010
Boston Celtics*,82,19880,2763,6418,.431,507,1452,.349,2256,4966,.454,1626,2110,.771,834,2249,3083,1553,585,389,1195,1820,7659,2010
Portland Trail Blazers*,82,19830,2899,6302,.460,487,1301,.374,2412,5001,.482,1430,1780,.803,786,2190,2976,1590,514,319,1082,1733,7715,2010
New Orleans Hornets*,82,19755,2851,6329,.450,575,1625,.354,2276,4704,.484,1453,1879,.773,822,2459,3281,1649,476,290,1089,1675,7730,2010
Orlando Magic*,82,19730,2936,6785,.433,444,1297,.342,2492,5488,.454,1421,1882,.755,864,2591,3455,1488,564,308,1072,1840,7737,2010
Houston Rockets*,82,19805,2991,6735,.444,464,1298,.357,2527,5437,.465,1296,1730,.749,873,2399,3272,1620,588,435,1012,1689,7742,2010
Detroit Pistons*,82,19905,2876,6380,.451,435,1228,.354,2441,5152,.474,1580,2039,.775,861,2453,3314,1651,461,342,964,1612,7767,2010
Charlotte Bobcats,82,19930,2883,6349,.454,558,1526,.366,2325,4823,.482,1457,1928,.756,877,2310,3187,1604,626,488,1206,1714,7781,2010
Atlanta Hawks*,82,19705,3002,6609,.454,528,1496,.353,2474,5113,.484,1385,1800,.769,955,2481,3436,1705,530,354,1121,1681,7917,2010
Philadelphia 76ers*,82,19755,2997,6489,.462,585,1595,.367,2412,4894,.493,1402,1792,.782,935,2285,3220,1799,575,400,1278,1786,7981,2010
Miami Heat*,82,19955,2920,6412,.455,591,1519,.389,2329,4893,.476,1609,2086,.771,896,2536,3432,1646,528,335,1246,1632,8040,2010
Los Angeles Lakers*,82,19780,3050,6825,.447,586,1700,.345,2464,5125,.481,1454,1931,.753,959,2440,3399,1854,635,392,1275,1816,8140,2010
Memphis Grizzlies,82,19805,3018,6378,.473,536,1510,.355,2482,4868,.510,1574,2043,.770,842,2431,3273,1735,632,443,1194,1786,8146,2010
Dallas Mavericks*,82,19805,3071,6752,.455,517,1379,.375,2554,5373,.475,1522,1907,.798,884,2509,3393,1611,589,334,1064,1645,8181,2010
Milwaukee Bucks,82,19780,2854,6233,.458,562,1486,.378,2292,4747,.483,1961,2480,.791,831,2527,3358,1730,616,376,1350,1842,8231,2010
New Jersey Nets,82,19830,2953,6385,.462,600,1536,.391,2353,4849,.485,1738,2281,.762,872,2523,3395,1793,567,393,1103,1680,8244,2010
Denver Nuggets*,82,19730,2966,6738,.440,601,1643,.366,2365,5095,.464,1742,2228,.782,991,2391,3382,1756,648,447,1265,1944,8275,2010
Utah Jazz*,82,19880,3019,6509,.464,534,1479,.361,2485,5030,.494,1703,2233,.763,908,2393,3301,1640,658,424,1323,1972,8275,2010
Toronto Raptors,82,19805,3172,6827,.465,629,1716,.367,2543,5111,.498,1379,1759,.784,895,2539,3434,1887,521,386,1093,1645,8352,2010
Chicago Bulls*,82,19930,3141,6864,.458,486,1400,.347,2655,5464,.486,1633,2077,.786,1017,2491,3508,1723,622,449,1177,1708,8401,2010
Minnesota Timberwolves,82,19805,3109,6561,.474,536,1420,.377,2573,5141,.500,1668,2145,.778,813,2539,3352,1765,610,484,1028,1642,8422,2010
Oklahoma City Thunder,82,19805,3230,6799,.475,524,1439,.364,2706,5360,.505,1468,1930,.761,884,2496,3380,1769,697,407,1140,1656,8452,2010
Washington Wizards,82,19705,3164,6565,.482,674,1740,.387,2490,4825,.516,1487,1959,.759,934,2491,3425,2015,593,431,1140,1638,8489,2010
Los Angeles Clippers,82,19880,3218,6805,.473,536,1431,.375,2682,5374,.499,1546,2035,.760,962,2653,3615,1951,652,414,1093,1609,8518,2010
Indiana Pacers,82,19830,3141,6862,.458,569,1519,.375,2572,5343,.481,1857,2431,.764,909,2708,3617,1731,635,444,1151,1692,8708,2010
Phoenix Suns,82,19755,3278,7025,.467,626,1635,.383,2652,5390,.492,1634,2108,.775,993,2352,3345,1741,706,369,1165,1877,8816,2010
New York Knicks,82,19805,3378,7041,.480,571,1625,.351,2807,5416,.518,1514,1998,.758,954,2826,3780,1774,654,437,1188,1592,8841,2010
Sacramento Kings,82,19905,3281,6792,.483,580,1430,.406,2701,5362,.504,1824,2412,.756,1018,2592,3610,1796,704,423,1178,1737,8966,2010
Golden State Warriors,82,19880,3401,7273,.468,582,1531,.380,2819,5742,.491,1828,2346,.779,1165,2695,3860,1980,647,414,1229,1927,9212,2010
League Average,82,19822,3044,6635,.459,545,1486,.367,2499,5149,.485,1564,2029,.771,905,2481,3386,1720,596,394,1151,1726,8196,2010
Charlotte Bobcats*,82,19880,2925,6536,.448,573,1696,.338,2352,4840,.486,1270,1710,.743,868,2382,3250,1666,614,502,1256,1804,7693,2011
Miami Heat*,82,19880,2813,6408,.439,524,1531,.342,2289,4877,.469,1577,2091,.754,856,2483,3339,1545,517,355,1184,1639,7727,2011
Portland Trail Blazers*,82,19855,2950,6352,.464,480,1399,.343,2470,4953,.499,1394,1870,.745,801,2322,3123,1583,485,333,1104,1767,7774,2011
Orlando Magic*,82,19730,2955,6739,.438,522,1437,.363,2433,5302,.459,1380,1830,.754,800,2481,3281,1550,551,288,1050,1819,7812,2011
Boston Celtics*,82,19780,2880,6390,.451,470,1375,.342,2410,5015,.481,1606,2152,.746,868,2418,3286,1585,578,386,1283,1777,7836,2011
Cleveland Cavaliers*,82,19780,2935,6633,.442,524,1511,.347,2411,5122,.471,1444,1907,.757,794,2366,3160,1661,542,325,1045,1708,7838,2011
Milwaukee Bucks*,82,19980,2870,6361,.451,438,1276,.343,2432,5085,.478,1692,2211,.765,790,2722,3512,1581,573,421,1254,1664,7870,2011
San Antonio Spurs*,82,19780,3025,6691,.452,412,1200,.343,2613,5491,.476,1433,1896,.756,814,2427,3241,1576,567,417,1032,1672,7895,2011
Los Angeles Lakers*,82,19830,3050,6840,.446,520,1585,.328,2530,5255,.481,1332,1776,.750,914,2546,3460,1792,573,363,1159,1737,7952,2011
Atlanta Hawks*,82,19855,3048,6623,.460,480,1392,.345,2568,5231,.491,1380,1852,.745,922,2471,3393,1719,506,359,1135,1582,7956,2011
Oklahoma City Thunder*,82,19805,3007,6718,.448,481,1414,.340,2526,5304,.476,1541,2018,.764,937,2397,3334,1618,616,384,1238,1755,8036,2011
Utah Jazz*,82,19755,2908,6471,.449,552,1559,.354,2356,4912,.480,1741,2286,.762,837,2376,3213,1628,632,445,1238,1818,8109,2011
Chicago Bulls*,82,19905,3043,6885,.442,584,1680,.348,2459,5205,.472,1457,1958,.744,916,2589,3505,1715,578,438,1090,1643,8127,2011
Detroit Pistons,82,19780,2965,6172,.480,568,1514,.375,2397,4658,.515,1630,2124,.767,814,2420,3234,1898,549,401,1174,1702,8128,2011
Dallas Mavericks*,82,19880,3107,6805,.457,525,1515,.347,2582,5290,.488,1402,1849,.758,922,2592,3514,1659,563,337,1195,1652,8141,2011
Washington Wizards,82,19830,3083,6664,.463,528,1466,.360,2555,5198,.492,1590,2088,.761,935,2530,3465,1772,569,415,1115,1684,8284,2011
New Jersey Nets,82,19780,3172,6593,.481,468,1278,.366,2704,5315,.509,1511,2021,.748,925,2683,3608,1960,638,421,1149,1647,8323,2011
Philadelphia 76ers,82,19805,3105,6573,.472,606,1542,.393,2499,5031,.497,1518,1983,.766,888,2470,3358,1810,621,332,1189,1534,8334,2011
Los Angeles Clippers,82,19705,3193,6792,.470,529,1457,.363,2664,5335,.499,1455,1910,.762,879,2490,3369,1926,686,363,1059,1588,8370,2011
Denver Nuggets*,82,19780,3088,6766,.456,523,1498,.349,2565,5268,.487,1695,2207,.768,955,2513,3468,1723,578,438,1235,1943,8394,2011
New Orleans Hornets,82,19830,3250,6730,.483,539,1517,.355,2711,5213,.520,1383,1841,.751,870,2586,3456,1925,574,367,1177,1597,8422,2011
Houston Rockets,82,19905,3236,6810,.475,489,1344,.364,2747,5466,.503,1464,1917,.764,875,2632,3507,1716,597,532,1207,1840,8425,2011
Indiana Pacers,82,19705,3113,6875,.453,510,1405,.363,2603,5470,.476,1774,2346,.756,969,2852,3821,1694,654,414,1227,1709,8510,2011
Memphis Grizzlies,82,19905,3277,6849,.478,572,1618,.354,2705,5231,.517,1402,1858,.755,907,2349,3256,1875,635,501,1165,1840,8528,2011
Sacramento Kings,82,19880,3199,6828,.469,497,1391,.357,2702,5437,.497,1663,2149,.774,909,2538,3447,1683,586,468,1120,1650,8558,2011
Phoenix Suns*,82,19730,3235,7165,.452,561,1582,.355,2674,5583,.479,1606,2114,.760,1081,2391,3472,1704,646,365,1065,1789,8637,2011
Toronto Raptors,82,19780,3194,6824,.468,609,1665,.366,2585,5159,.501,1683,2146,.784,933,2453,3386,1889,580,360,1040,1730,8680,2011
New York Knicks,82,19880,3352,6902,.486,553,1571,.352,2799,5331,.525,1429,1896,.754,959,2724,3683,1723,585,368,1182,1576,8686,2011
Minnesota Timberwolves,82,19780,3343,6961,.480,618,1690,.366,2725,5271,.517,1534,1981,.774,917,2640,3557,2103,721,442,1173,1686,8838,2011
Golden State Warriors,82,19730,3409,7033,.485,567,1514,.375,2842,5519,.515,1832,2390,.767,1100,2842,3942,1979,645,407,1442,1757,9217,2011
League Average,82,19817,3091,6700,.461,527,1487,.355,2564,5212,.492,1527,2013,.759,899,2523,3421,1742,592,398,1166,1710,8237,2011
Boston Celtics*,82,19780,2768,6371,.434,443,1304,.340,2325,5067,.459,1494,1975,.756,862,2387,3249,1533,574,364,1262,1659,7473,2012
Chicago Bulls*,82,19830,2805,6523,.430,427,1308,.326,2378,5215,.456,1450,1898,.764,828,2322,3150,1556,568,477,1159,1645,7487,2012
Milwaukee Bucks,82,19830,2834,6342,.447,437,1309,.334,2397,5033,.476,1498,1946,.770,836,2629,3465,1657,507,392,1245,1694,7603,2012
Orlando Magic*,82,19830,2865,6569,.436,516,1476,.350,2349,5093,.461,1441,1940,.743,805,2450,3255,1646,606,310,1136,1791,7687,2012
New Orleans Hornets*,82,19830,2882,6306,.457,557,1562,.357,2325,4744,.490,1390,1805,.770,769,2457,3226,1739,497,396,1192,1674,7711,2012
Miami Heat*,82,19780,2869,6614,.434,546,1584,.345,2323,5030,.462,1473,1980,.744,864,2349,3213,1651,574,246,1081,1788,7757,2012
Portland Trail Blazers*,82,19805,2904,6218,.467,529,1440,.367,2375,4778,.497,1434,1869,.767,868,2385,3253,1573,566,339,1286,1743,7771,2012
Los Angeles Lakers*,82,19830,3008,6888,.437,558,1668,.335,2450,5220,.469,1246,1628,.765,1002,2399,3401,1827,585,372,1116,1700,7820,2012
Atlanta Hawks*,82,19730,3009,6537,.460,459,1358,.338,2550,5179,.492,1380,1782,.774,839,2488,3327,1751,548,348,1026,1517,7857,2012
Dallas Mavericks*,82,19705,2996,6656,.450,508,1480,.343,2488,5176,.481,1373,1830,.750,880,2459,3339,1689,623,303,1114,1650,7873,2012
Charlotte Bobcats,82,19805,2956,6492,.455,577,1609,.359,2379,4883,.487,1489,1908,.780,804,2446,3250,1777,601,496,1082,1730,7978,2012
Philadelphia 76ers*,82,19930,2996,6638,.451,468,1375,.340,2528,5263,.480,1536,1987,.773,881,2608,3489,1762,583,376,1168,1544,7996,2012
Memphis Grizzlies*,82,19880,2967,6489,.457,587,1592,.369,2380,4897,.486,1482,1948,.761,905,2387,3292,1724,613,505,1367,1754,8003,2012
San Antonio Spurs*,82,19780,3127,6860,.456,479,1305,.367,2648,5555,.477,1301,1698,.766,884,2494,3378,1685,567,374,1095,1701,8034,2012
New Jersey Nets,82,20005,3069,6602,.465,507,1393,.364,2562,5209,.492,1589,2115,.751,849,2575,3424,1824,561,375,1010,1638,8234,2012
Detroit Pistons,82,19880,3110,6405,.486,523,1461,.358,2587,4944,.523,1503,1962,.766,866,2470,3336,1910,568,381,1160,1545,8246,2012
Indiana Pacers*,82,19780,3071,6837,.449,511,1423,.359,2560,5414,.473,1618,2157,.750,931,2618,3549,1670,615,467,1143,1758,8271,2012
Oklahoma City Thunder*,82,20005,3123,6823,.458,482,1335,.361,2641,5488,.481,1557,2093,.744,932,2395,3327,1712,587,356,1152,1767,8285,2012
Utah Jazz,82,19880,2967,6460,.459,592,1573,.376,2375,4887,.486,1777,2285,.778,925,2426,3351,1700,609,411,1199,1802,8303,2012
Los Angeles Clippers,82,19855,3046,6688,.455,584,1598,.365,2462,5090,.484,1670,2167,.771,914,2410,3324,1827,659,404,1125,1811,8346,2012
Denver Nuggets*,82,19705,3153,6876,.459,576,1675,.344,2577,5201,.495,1539,2036,.756,864,2525,3389,1820,611,488,1127,1864,8421,2012
Houston Rockets,82,19880,3266,6979,.468,448,1250,.358,2818,5729,.492,1526,1954,.781,955,2552,3507,1707,588,449,1125,1754,8506,2012
Cleveland Cavaliers,82,19755,3232,6804,.475,664,1614,.411,2568,5190,.495,1438,1894,.759,894,2676,3570,1984,619,489,1111,1747,8566,2012
Washington Wizards,82,19930,3174,6741,.471,560,1500,.373,2614,5241,.499,1676,2202,.761,994,2607,3601,1898,624,413,1293,1662,8584,2012
Sacramento Kings,82,19855,3260,6826,.478,480,1353,.355,2780,5473,.508,1589,2085,.762,868,2508,3376,1779,666,464,1204,1723,8589,2012
Toronto Raptors,82,19780,3213,6668,.482,541,1438,.376,2672,5230,.511,1672,2175,.769,912,2457,3369,1854,625,456,1141,1620,8639,2012
Golden State Warriors,82,19830,3173,6788,.467,567,1586,.358,2606,5202,.501,1755,2262,.776,1051,2623,3674,2029,672,352,1324,1512,8668,2012
New York Knicks*,82,19780,3242,6870,.472,536,1442,.372,2706,5428,.499,1650,2165,.762,964,2646,3610,1682,586,360,1250,1703,8670,2012
Phoenix Suns,82,20005,3309,7018,.472,585,1595,.367,2724,5423,.502,1481,1964,.754,985,2647,3632,1890,644,356,1189,1740,8684,2012
Minnesota Timberwolves,82,19780,3230,6902,.468,639,1707,.374,2591,5195,.499,1733,2227,.778,913,2577,3490,2031,777,447,1183,1717,8832,2012
League Average,82,19835,3054,6660,.459,530,1477,.358,2525,5183,.487,1525,1998,.763,895,2499,3394,1763,601,399,1169,1698,8163,2012
Chicago Bulls*,66,15940,2284,5420,.421,305,939,.325,1979,4481,.442,946,1279,.740,750,1889,2639,1245,490,343,876,1166,5819,2013
Boston Celtics*,66,15940,2207,5262,.419,344,1117,.308,1863,4145,.449,1138,1498,.760,781,2070,2851,1233,515,304,1035,1217,5896,2013
Philadelphia 76ers*,66,15915,2263,5302,.427,357,1070,.334,1906,4232,.450,1017,1352,.752,706,2181,2887,1293,391,316,918,1070,5900,2013
Miami Heat*,66,16040,2285,5267,.434,479,1318,.363,1806,3949,.457,1056,1457,.725,727,1897,2624,1297,549,280,1107,1356,6105,2013
Memphis Grizzlies*,66,15940,2278,5132,.444,417,1209,.345,1861,3923,.474,1163,1522,.764,729,1954,2683,1274,518,363,1130,1275,6136,2013
Atlanta Hawks*,66,16165,2380,5366,.444,391,1137,.344,1989,4229,.470,997,1324,.753,712,2079,2791,1354,494,313,999,1263,6148,2013
Orlando Magic*,66,15965,2372,5287,.449,414,1192,.347,1958,4095,.478,1005,1302,.772,667,2061,2728,1350,495,273,867,1308,6163,2013
New Orleans Hornets,66,15940,2305,5188,.444,425,1342,.317,1880,3846,.489,1129,1487,.759,731,1910,2641,1379,523,380,915,1235,6164,2013
Toronto Raptors,66,15965,2234,5130,.435,401,1224,.328,1833,3906,.469,1335,1795,.744,677,1997,2674,1327,478,322,870,1214,6204,2013
Indiana Pacers*,66,15990,2305,5304,.435,442,1259,.351,1863,4045,.461,1179,1617,.729,794,1998,2792,1292,433,398,985,1428,6231,2013
New York Knicks*,66,15940,2316,5238,.442,444,1238,.359,1872,4000,.468,1171,1590,.736,717,2045,2762,1248,536,334,1125,1437,6247,2013
Dallas Mavericks*,66,16065,2347,5390,.435,473,1368,.346,1874,4022,.466,1092,1456,.750,725,2173,2898,1351,561,265,971,1213,6259,2013
Los Angeles Clippers*,66,15965,2279,5098,.447,460,1261,.365,1819,3837,.474,1251,1678,.746,712,1914,2626,1368,396,296,966,1401,6269,2013
Detroit Pistons,66,15965,2378,5147,.462,395,1114,.355,1983,4033,.492,1162,1518,.765,703,1985,2688,1485,563,348,959,1283,6313,2013
Los Angeles Lakers*,66,16065,2492,5703,.437,443,1274,.348,2049,4429,.463,901,1215,.742,758,1946,2704,1446,556,302,745,1332,6328,2013
San Antonio Spurs*,66,15940,2512,5560,.452,412,1166,.353,2100,4394,.478,932,1233,.756,680,2039,2719,1291,489,330,906,1244,6368,2013
Oklahoma City Thunder*,66,15990,2405,5629,.427,421,1231,.342,1984,4398,.451,1167,1519,.768,835,1889,2724,1312,542,321,937,1322,6398,2013
Portland Trail Blazers,66,15965,2476,5349,.463,442,1217,.363,2034,4132,.492,1062,1421,.747,730,2062,2792,1392,499,314,982,1306,6456,2013
Houston Rockets,66,16065,2474,5427,.456,369,1136,.325,2105,4291,.491,1142,1490,.766,729,2027,2756,1321,495,340,972,1215,6459,2013
Washington Wizards,66,15865,2422,5352,.453,426,1216,.350,1996,4136,.483,1227,1618,.758,811,2062,2873,1420,520,300,1004,1231,6497,2013
Phoenix Suns,66,15840,2505,5510,.455,398,1131,.352,2107,4379,.481,1100,1444,.762,802,2064,2866,1416,526,288,929,1293,6508,2013
Milwaukee Bucks,66,15865,2449,5453,.449,438,1247,.351,2011,4206,.478,1181,1535,.769,813,2138,2951,1433,499,297,1049,1278,6517,2013
Utah Jazz*,66,16165,2403,5310,.453,428,1259,.340,1975,4051,.488,1302,1727,.754,728,1988,2716,1355,494,375,968,1366,6536,2013
New Jersey Nets,66,15890,2501,5294,.472,431,1151,.374,2070,4143,.500,1106,1494,.740,780,2032,2812,1539,525,330,943,1274,6539,2013
Minnesota Timberwolves,66,15940,2572,5656,.455,406,1195,.340,2166,4461,.486,1059,1402,.755,771,2096,2867,1422,549,377,875,1435,6609,2013
Cleveland Cavaliers,66,15965,2536,5431,.467,448,1236,.362,2088,4195,.498,1095,1464,.748,752,2073,2825,1527,524,409,917,1381,6615,2013
Charlotte Bobcats,66,15890,2568,5411,.475,406,1142,.356,2162,4269,.506,1115,1486,.750,778,2193,2971,1537,499,378,890,1341,6657,2013
Golden State Warriors,66,15915,2461,5431,.453,468,1281,.365,1993,4150,.480,1288,1725,.747,869,2157,3026,1527,499,328,978,1095,6678,2013
Denver Nuggets*,66,16040,2541,5569,.456,571,1489,.383,1970,4080,.483,1029,1356,.759,730,1928,2658,1528,524,439,1028,1452,6682,2013
Sacramento Kings,66,15915,2668,5609,.476,439,1236,.355,2229,4373,.510,1118,1468,.762,815,2154,2969,1571,518,423,1014,1313,6893,2013
League Average,66,15968,2407,5374,.448,423,1213,.349,1984,4161,.477,1116,1482,.752,750,2033,2784,1384,507,336,962,1291,6353,2013
Memphis Grizzlies*,82,19805,2748,6312,.435,504,1489,.338,2244,4823,.465,1319,1763,.748,845,2359,3204,1599,600,450,1268,1643,7319,2014
Indiana Pacers*,81,19590,2797,6657,.420,440,1344,.327,2357,5313,.444,1314,1728,.760,909,2401,3310,1555,611,459,1096,1777,7348,2014
Chicago Bulls*,82,19830,2906,6565,.443,453,1309,.346,2453,5256,.467,1350,1826,.739,901,2469,3370,1545,600,477,1123,1609,7615,2014
Los Angeles Clippers*,82,19730,2834,6397,.443,627,1682,.373,2207,4715,.468,1465,1956,.749,891,2315,3206,1812,606,335,1319,1712,7760,2014
Miami Heat*,82,19880,2919,6633,.440,624,1783,.350,2295,4850,.473,1329,1735,.766,921,2369,3290,1655,649,262,1280,1673,7791,2014
Brooklyn Nets*,82,19855,3066,6614,.464,518,1415,.366,2548,5199,.490,1148,1571,.731,878,2336,3214,1756,614,390,1102,1751,7798,2014
Boston Celtics*,81,19840,2926,6639,.441,550,1610,.342,2376,5029,.472,1434,1937,.740,925,2603,3528,1752,634,378,1239,1574,7836,2014
New York Knicks*,82,19730,2916,6365,.458,639,1789,.357,2277,4576,.498,1378,1821,.757,824,2591,3415,1580,523,327,1242,1576,7849,2014
Washington Wizards,82,19855,2944,6697,.440,586,1680,.349,2358,5017,.470,1378,1867,.738,903,2719,3622,1767,639,358,1193,1569,7852,2014
Philadelphia 76ers,82,19755,3017,6643,.454,549,1574,.349,2468,5069,.487,1331,1752,.760,903,2704,3607,1870,590,396,1175,1331,7914,2014
Oklahoma City Thunder*,82,19830,2966,6972,.425,610,1761,.346,2356,5211,.452,1372,1773,.774,987,2350,3337,1681,673,322,1212,1698,7914,2014
San Antonio Spurs*,82,19880,3079,6960,.442,519,1471,.353,2560,5489,.466,1246,1639,.760,912,2577,3489,1756,675,405,1221,1565,7923,2014
Atlanta Hawks*,82,19855,3073,6823,.450,620,1635,.379,2453,5188,.473,1233,1617,.763,928,2659,3587,1825,689,350,1249,1543,7999,2014
New Orleans Hornets,82,19780,3030,6435,.471,632,1688,.374,2398,4747,.505,1339,1764,.759,835,2391,3226,1915,648,492,1086,1534,8031,2014
Minnesota Timberwolves,82,19730,3113,6657,.468,576,1559,.369,2537,5098,.498,1243,1652,.752,871,2583,3454,1832,661,481,1302,1847,8045,2014
Utah Jazz,82,19880,3003,6550,.458,560,1513,.370,2443,5037,.485,1479,1953,.757,901,2446,3347,1689,640,480,1206,1670,8045,2014
Toronto Raptors,82,19980,2971,6493,.458,546,1511,.361,2425,4982,.487,1604,2148,.747,877,2544,3421,1796,578,387,1169,1650,8092,2014
Detroit Pistons,82,19805,3056,6655,.459,604,1676,.360,2452,4979,.492,1389,1823,.762,911,2514,3425,1837,691,472,1126,1630,8105,2014
Golden State Warriors*,82,19805,3051,6954,.439,657,1896,.347,2394,5058,.473,1464,1958,.748,907,2596,3503,1931,670,399,1110,1571,8223,2014
Milwaukee Bucks*,82,19830,3152,6946,.454,529,1519,.348,2623,5427,.483,1398,1841,.759,1019,2757,3776,1893,658,362,1310,1567,8231,2014
Portland Trail Blazers,82,19855,3224,6807,.474,521,1531,.340,2703,5276,.512,1286,1690,.761,901,2578,3479,1944,691,359,1074,1537,8255,2014
Los Angeles Lakers*,82,19755,3253,7180,.453,613,1718,.357,2640,5462,.483,1167,1594,.732,947,2551,3498,1918,696,396,1061,1891,8286,2014
Denver Nuggets*,82,19905,3121,7025,.444,687,1894,.363,2434,5131,.474,1358,1858,.731,1020,2391,3411,1936,658,554,1305,1775,8287,2014
Orlando Magic,82,19780,3169,6842,.463,617,1721,.359,2552,5121,.498,1336,1811,.738,888,2618,3506,1946,592,430,1020,1353,8291,2014
Cleveland Cavaliers,82,19730,3109,6527,.476,610,1639,.372,2499,4888,.511,1469,1987,.739,889,2563,3452,1963,624,560,1249,1615,8297,2014
Phoenix Suns,82,19805,3181,6771,.470,568,1464,.388,2613,5307,.492,1405,1855,.757,958,2598,3556,1870,684,421,1258,1511,8335,2014
Dallas Mavericks,82,19980,3067,6890,.445,642,1789,.359,2425,5101,.475,1566,2079,.753,985,2752,3737,1805,698,340,1202,1547,8342,2014
Houston Rockets*,82,19780,3184,7007,.454,661,1798,.368,2523,5209,.484,1374,1771,.776,876,2539,3415,1858,693,498,1210,1674,8403,2014
Charlotte Bobcats,82,19805,3185,6762,.471,716,1847,.388,2469,4915,.502,1332,1784,.747,971,2645,3616,2071,569,565,1152,1746,8418,2014
Sacramento Kings,82,19830,3222,6831,.472,625,1762,.355,2597,5069,.512,1550,1980,.783,973,2601,3574,2058,624,517,1208,1636,8619,2014
League Average,82,19816,3043,6720,.453,587,1636,.359,2456,5085,.483,1369,1818,.753,915,2537,3453,1814,639,421,1192,1626,8041,2014
Chicago Bulls*,82,19930,2867,6660,.430,538,1532,.351,2329,5128,.454,1256,1668,.753,876,2508,3384,1604,621,490,1178,1714,7528,2015
Indiana Pacers*,82,19780,2850,6785,.420,538,1561,.345,2312,5224,.443,1334,1768,.755,855,2521,3376,1525,593,378,1120,1793,7572,2015
Memphis Grizzlies*,82,19805,2924,6500,.450,615,1731,.355,2309,4769,.484,1292,1686,.766,809,2403,3212,1632,591,410,1162,1553,7755,2015
Charlotte Bobcats*,82,19905,3022,6838,.442,665,1800,.369,2357,5038,.468,1251,1649,.759,785,2766,3551,1718,514,415,1090,1716,7960,2015
Miami Heat*,82,19880,2961,6475,.457,694,1917,.362,2267,4558,.497,1374,1832,.750,886,2420,3306,1751,667,256,1369,1675,7990,2015
San Antonio Spurs*,82,19755,3096,6976,.444,529,1500,.353,2567,5476,.469,1285,1691,.760,862,2600,3462,1669,628,379,1137,1585,8006,2015
Toronto Raptors*,82,19955,2957,6573,.450,568,1578,.360,2389,4995,.478,1557,2071,.752,854,2505,3359,1719,596,352,1224,1815,8039,2015
New York Knicks,82,19855,2934,6401,.458,713,1921,.371,2221,4480,.496,1568,2050,.765,843,2600,3443,1618,513,277,1193,1611,8149,2015
Washington Wizards*,82,20055,3038,6632,.458,612,1763,.347,2426,4869,.498,1462,1912,.765,827,2633,3460,1824,631,320,1314,1600,8150,2015
Golden State Warriors*,82,19830,3019,6920,.436,569,1656,.344,2450,5264,.465,1548,2023,.765,878,2671,3549,1683,649,342,1232,1584,8155,2015
Brooklyn Nets*,82,19880,2980,6511,.458,662,1802,.367,2318,4709,.492,1539,2026,.760,921,2594,3515,1723,608,337,1296,1704,8161,2015
Oklahoma City Thunder*,82,19805,2984,6842,.436,705,1968,.358,2279,4874,.468,1512,2080,.727,900,2456,3356,1785,669,296,1248,1672,8185,2015
Boston Celtics,82,19730,3101,6675,.465,539,1553,.347,2562,5122,.500,1517,1993,.761,871,2596,3467,1813,609,373,1168,1564,8258,2015
Los Angeles Clippers*,82,19755,3068,6958,.441,595,1791,.332,2473,5167,.479,1547,2049,.755,1011,2575,3586,1908,570,284,1261,1919,8278,2015
Atlanta Hawks*,82,19830,3163,6843,.462,654,1793,.365,2509,5050,.497,1341,1793,.748,882,2688,3570,1901,672,354,1247,1643,8321,2015
Cleveland Cavaliers,82,19930,3097,6847,.452,765,2083,.367,2332,4764,.490,1365,1803,.757,841,2648,3489,2037,587,461,1144,1599,8324,2015
Orlando Magic,82,19955,3126,6861,.456,659,1778,.371,2467,5083,.485,1449,1881,.770,859,2746,3605,1848,581,445,1146,1500,8360,2015
Utah Jazz,82,19780,3138,6639,.473,599,1591,.376,2539,5048,.503,1504,1945,.773,846,2640,3486,1788,617,401,1034,1673,8379,2015
New Orleans Pelicans,82,19855,3055,6567,.465,652,1827,.357,2403,4740,.507,1637,2176,.752,881,2538,3419,1845,577,504,1185,1664,8399,2015
Dallas Mavericks*,82,19830,3096,6673,.464,678,1888,.359,2418,4785,.505,1530,2019,.758,943,2569,3512,1808,635,288,1312,1633,8400,2015
Phoenix Suns,82,19755,3118,6840,.456,556,1632,.341,2562,5208,.492,1621,2115,.766,926,2586,3512,1664,613,332,1258,1749,8413,2015
Portland Trail Blazers*,82,19855,3248,7203,.451,534,1504,.355,2714,5699,.476,1396,1822,.766,944,2622,3566,1675,639,304,985,1698,8426,2015
Houston Rockets*,82,19830,3197,7218,.443,666,1889,.353,2531,5329,.475,1395,1844,.757,977,2439,3416,1821,704,460,1149,1993,8455,2015
Sacramento Kings,82,19830,3103,6734,.461,696,1833,.380,2407,4901,.491,1577,2139,.737,813,2568,3381,1927,637,459,1116,1897,8479,2015
Milwaukee Bucks,82,19880,3146,6722,.468,697,1826,.382,2449,4896,.500,1511,2011,.751,961,2608,3569,1870,640,413,1158,1690,8500,2015
Minnesota Timberwolves,82,19855,3321,7048,.471,663,1820,.364,2658,5228,.508,1244,1645,.756,908,2717,3625,1875,644,457,1346,1936,8549,2015
Detroit Pistons,82,19780,3208,6820,.470,683,1872,.365,2525,4948,.510,1487,1967,.756,913,2612,3525,2001,670,403,1230,1699,8586,2015
Denver Nuggets,82,19755,3238,7086,.457,605,1724,.351,2633,5362,.491,1654,2168,.763,930,2665,3595,1843,694,459,1178,1778,8735,2015
Los Angeles Lakers,82,19705,3440,7350,.468,666,1843,.361,2774,5507,.504,1412,1942,.727,1068,2950,4018,2112,790,387,1164,1580,8958,2015
Philadelphia 76ers,82,19855,3284,6975,.471,739,1998,.370,2545,4977,.511,1705,2261,.754,976,2871,3847,2144,736,558,1391,1686,9012,2015
League Average,82,19840,3093,6806,.454,635,1766,.360,2458,5040,.488,1462,1934,.756,895,2611,3505,1804,630,386,1201,1697,8283,2015
Utah Jazz,82,19705,2935,6587,.446,604,1670,.362,2331,4917,.474,1309,1760,.744,811,2406,3217,1594,674,382,1076,1604,7783,2016
Memphis Grizzlies*,82,19905,2954,6684,.442,663,1889,.351,2291,4795,.478,1225,1651,.742,864,2616,3480,1652,604,424,1257,1662,7796,2016
San Antonio Spurs*,82,19955,3044,6861,.444,558,1550,.360,2486,5311,.468,1307,1754,.745,813,2643,3456,1699,648,362,1167,1613,7953,2016
Indiana Pacers,82,19855,2949,6784,.435,591,1713,.345,2358,5071,.465,1469,1951,.753,800,2704,3504,1633,617,386,1045,1754,7958,2016
Atlanta Hawks*,82,19730,2991,6815,.439,720,2112,.341,2271,4703,.483,1262,1651,.764,948,2631,3579,1931,604,404,1317,1611,7964,2016
Miami Heat,82,19730,2960,6523,.454,666,1887,.353,2294,4636,.495,1391,1905,.730,894,2467,3361,1748,646,359,1215,1715,7977,2016
Charlotte Hornets,82,19905,3020,6863,.440,649,1816,.357,2371,5047,.470,1292,1673,.772,728,2890,3618,1815,502,440,1033,1708,7981,2016
Milwaukee Bucks*,82,19930,2917,6681,.437,676,1974,.342,2241,4707,.476,1478,1993,.742,938,2576,3514,1831,708,392,1425,1649,7988,2016
Chicago Bulls*,82,19880,3095,7109,.435,538,1605,.335,2557,5504,.465,1291,1723,.749,963,2598,3561,1657,614,443,1000,1736,8019,2016
Washington Wizards*,82,19955,2965,6844,.433,657,1885,.349,2308,4959,.465,1434,1942,.738,821,2599,3420,1634,655,350,1145,1610,8021,2016
New Orleans Pelicans*,82,19780,3108,6814,.456,537,1605,.335,2571,5209,.494,1329,1751,.759,870,2537,3407,1700,555,475,1003,1533,8082,2016
Portland Trail Blazers*,82,19855,3130,7123,.439,524,1552,.338,2606,5571,.468,1298,1713,.758,902,2754,3656,1669,655,297,999,1534,8082,2016
Cleveland Cavaliers*,82,19780,3121,6850,.456,634,1848,.343,2487,5002,.497,1214,1629,.745,885,2487,3372,1974,642,368,1092,1685,8090,2016
Detroit Pistons,82,19830,3106,6817,.456,635,1789,.355,2471,5028,.491,1312,1699,.772,877,2740,3617,1949,572,391,1146,1584,8159,2016
Golden State Warriors*,82,19730,3031,7084,.428,592,1757,.337,2439,5327,.458,1534,2011,.763,963,2690,3653,1718,680,293,1329,1541,8188,2016
Los Angeles Clippers*,82,19730,2984,6745,.442,683,1959,.349,2301,4786,.481,1560,2105,.741,868,2649,3517,1904,548,245,1171,1766,8211,2016
Houston Rockets*,82,19805,3092,6983,.443,605,1881,.322,2487,5102,.487,1451,1932,.751,973,2621,3594,1752,726,437,1342,1730,8240,2016
Brooklyn Nets*,82,19930,3150,6913,.456,696,1944,.358,2454,4969,.494,1278,1748,.731,937,2699,3636,1944,643,372,1137,1641,8274,2016
Toronto Raptors*,82,19855,3116,6787,.459,633,1828,.346,2483,4959,.501,1410,1923,.733,922,2559,3481,1870,567,413,1182,1668,8275,2016
Philadelphia 76ers,82,19805,3045,6785,.449,658,1879,.350,2387,4906,.487,1530,2023,.756,940,2853,3793,1942,779,454,1374,1657,8278,2016
Boston Celtics*,82,19880,3125,6943,.450,607,1804,.336,2518,5139,.490,1442,1909,.755,893,2772,3665,1798,583,431,1239,1545,8299,2016
New York Knicks,82,19855,3031,6592,.460,694,1825,.380,2337,4767,.490,1543,2032,.759,898,2669,3567,1783,659,353,1153,1564,8299,2016
Orlando Magic,82,19755,3112,6720,.463,682,1853,.368,2430,4867,.499,1410,1878,.751,825,2739,3564,1921,635,441,1185,1467,8316,2016
Oklahoma City Thunder,82,19830,3085,7008,.440,681,1984,.343,2404,5024,.479,1494,2005,.745,917,2587,3504,1815,642,377,1118,1675,8345,2016
Dallas Mavericks*,82,19880,3117,6930,.450,741,2034,.364,2376,4896,.485,1415,1879,.753,1006,2778,3784,1830,602,314,1339,1816,8390,2016
Phoenix Suns,82,19880,3149,6972,.452,633,1798,.352,2516,5174,.486,1540,2030,.759,951,2766,3717,1734,651,337,1276,1664,8471,2016
Denver Nuggets,82,19880,3164,6909,.458,631,1823,.346,2533,5086,.498,1652,2208,.748,899,2798,3697,1894,611,504,1177,1698,8611,2016
Sacramento Kings,82,19855,3238,7094,.456,718,2055,.349,2520,5039,.500,1420,1898,.748,898,2479,3377,1912,712,508,1059,1958,8614,2016
Los Angeles Lakers,82,19930,3180,6817,.466,697,1921,.363,2483,4896,.507,1577,2118,.745,824,2797,3621,1966,611,396,1068,1589,8634,2016
Minnesota Timberwolves,82,19805,3373,6933,.487,697,1897,.367,2676,5036,.531,1294,1704,.759,953,2619,3572,1933,686,449,1243,1751,8737,2016
League Average,82,19840,3076,6852,.449,643,1838,.350,2433,5014,.485,1405,1873,.750,893,2657,3550,1807,634,393,1177,1658,8201,2016
San Antonio Spurs*,82,19705,2928,6709,.436,541,1634,.331,2387,5075,.470,1221,1611,.758,747,2576,3323,1707,592,317,1214,1597,7618,2017
Utah Jazz,82,19955,2920,6549,.446,649,1819,.357,2271,4730,.480,1374,1842,.746,764,2522,3286,1568,652,385,1146,1629,7863,2017
Toronto Raptors*,82,19780,2991,6732,.444,717,1922,.373,2274,4810,.473,1354,1809,.748,782,2561,3343,1781,534,442,1094,1801,8053,2017
Cleveland Cavaliers*,82,19855,3019,6736,.448,647,1862,.347,2372,4874,.487,1378,1855,.743,760,2604,3364,1756,590,362,1092,1690,8063,2017
Miami Heat*,82,19830,3054,6914,.442,605,1742,.347,2449,5172,.474,1356,1761,.770,803,2580,3383,1657,612,337,1060,1608,8069,2017
Atlanta Hawks*,82,19830,3046,7058,.432,679,2008,.338,2367,5050,.469,1366,1810,.755,944,2869,3813,1808,706,411,1324,1500,8137,2017
Los Angeles Clippers*,82,19830,3015,6946,.434,645,1909,.338,2370,5037,.471,1543,2055,.751,968,2861,3829,1740,583,259,1260,1842,8218,2017
Indiana Pacers*,82,19880,3065,6962,.440,679,2035,.334,2386,4927,.484,1428,1901,.751,877,2774,3651,1707,634,366,1297,1676,8237,2017
Charlotte Hornets*,82,19855,3098,6971,.444,726,2081,.349,2372,4890,.485,1334,1735,.769,726,2936,3662,1901,553,448,1103,1670,8256,2017
New York Knicks,82,19805,3114,7035,.443,626,1838,.341,2488,5197,.479,1435,1904,.754,890,2733,3623,1703,589,343,927,1520,8289,2017
Memphis Grizzlies*,82,19830,2947,6459,.456,797,2185,.365,2150,4274,.503,1619,2107,.768,830,2711,3541,1792,576,469,1328,1732,8310,2017
Detroit Pistons*,82,19880,3182,6903,.461,596,1679,.355,2586,5224,.495,1351,1726,.783,725,2763,3488,1766,583,366,1099,1773,8311,2017
Boston Celtics*,82,19780,3075,6973,.441,643,1912,.336,2432,5061,.481,1613,2136,.755,932,2838,3770,1715,622,450,1348,1718,8406,2017
Dallas Mavericks*,82,20005,3144,6971,.451,743,2170,.342,2401,4801,.500,1382,1873,.738,868,2887,3755,1800,617,363,1142,1757,8413,2017
Oklahoma City Thunder*,82,19830,3150,7192,.438,667,1949,.342,2483,5243,.474,1474,1950,.756,923,2373,3296,1767,719,373,1068,1653,8441,2017
Chicago Bulls,82,19905,3234,7333,.441,651,1885,.345,2583,5448,.474,1337,1813,.737,969,2798,3767,1848,655,465,974,1535,8456,2017
Milwaukee Bucks,82,19830,3097,6817,.454,765,2171,.352,2332,4646,.502,1506,1961,.768,942,2583,3525,2013,679,462,1269,1600,8465,2017
Orlando Magic,82,19905,3150,6850,.460,732,2041,.359,2418,4809,.503,1470,1971,.746,832,2800,3632,1899,620,448,1240,1497,8502,2017
Golden State Warriors*,82,19880,3188,7330,.435,640,1928,.332,2548,5402,.472,1523,2013,.757,937,2662,3599,1823,710,336,1185,1627,8539,2017
Portland Trail Blazers*,82,19805,3146,6945,.453,700,1888,.371,2446,5057,.484,1562,2129,.734,867,2716,3583,1770,630,424,1088,1597,8554,2017
Washington Wizards,82,19755,3170,6868,.462,737,1987,.371,2433,4881,.498,1498,1947,.769,773,2858,3631,1846,661,356,1325,1651,8575,2017
Denver Nuggets,82,19830,3182,6904,.461,754,2033,.371,2428,4871,.498,1491,1958,.761,799,2700,3499,1924,660,517,1122,1712,8609,2017
Minnesota Timberwolves,82,19880,3276,6962,.471,742,2089,.355,2534,4873,.520,1394,1842,.757,877,2558,3435,1857,638,427,1220,1768,8688,2017
Brooklyn Nets,82,19755,3345,6984,.479,775,2100,.369,2570,4884,.526,1227,1608,.763,840,2719,3559,2006,720,430,1162,1510,8692,2017
Houston Rockets*,82,19830,3200,6977,.459,796,2206,.361,2404,4771,.504,1525,2018,.756,970,2690,3660,2015,734,404,1360,1847,8721,2017
New Orleans Pelicans,82,19780,3218,6877,.468,754,2043,.369,2464,4834,.510,1544,1972,.783,730,2912,3642,1899,602,423,1127,1630,8734,2017
Los Angeles Lakers,82,19730,3323,7023,.473,700,2016,.347,2623,5007,.524,1420,1942,.731,897,2915,3812,2022,617,458,1037,1573,8766,2017
Phoenix Suns,82,19705,3208,6870,.467,770,2041,.377,2438,4829,.505,1631,2177,.749,813,2770,3583,1837,782,449,1224,1770,8817,2017
Philadelphia 76ers,82,19805,3253,7005,.464,638,1776,.359,2615,5229,.500,1683,2141,.786,913,2987,3900,1919,711,466,1241,1571,8827,2017
Sacramento Kings,82,19805,3327,7194,.462,839,2293,.366,2488,4901,.508,1450,1902,.762,926,2765,3691,1986,722,437,1308,1800,8943,2017
League Average,82,19828,3136,6935,.452,698,1975,.354,2437,4960,.491,1450,1916,.757,854,2734,3588,1828,643,406,1179,1662,8419,2017
Utah Jazz*,82,19755,2978,6723,.443,671,1874,.358,2307,4849,.476,1308,1701,.769,742,2554,3296,1463,598,312,995,1655,7935,2018
San Antonio Spurs*,82,19805,3032,6839,.443,668,1942,.344,2364,4897,.483,1315,1705,.771,800,2600,3400,1757,614,333,1184,1623,8047,2018
Memphis Grizzlies*,82,19905,2864,6465,.443,813,2299,.354,2051,4166,.492,1658,2202,.753,761,2692,3453,1645,574,410,1171,1708,8199,2018
Dallas Mavericks,82,19780,3035,6477,.469,788,2074,.380,2247,4403,.510,1411,1827,.772,727,2923,3650,1743,535,280,1225,1591,8269,2018
Miami Heat,82,19780,3108,6904,.450,639,1864,.343,2469,5040,.490,1518,1940,.782,837,2737,3574,1611,556,398,1121,1530,8373,2018
Chicago Bulls*,82,19780,3236,7099,.456,731,2121,.345,2505,4978,.503,1197,1555,.770,843,2698,3541,1939,602,378,1100,1541,8400,2018
Detroit Pistons,82,19805,3144,6830,.460,767,2098,.366,2377,4732,.502,1346,1726,.780,656,2861,3517,1929,551,339,1046,1434,8401,2018
Toronto Raptors*,82,19780,3052,6801,.449,794,2240,.354,2258,4561,.495,1519,1948,.780,831,2619,3450,1786,547,392,1200,1666,8417,2018
Milwaukee Bucks*,82,19780,3116,6802,.458,816,2312,.353,2300,4490,.512,1464,1900,.771,845,2636,3481,1974,609,375,1205,1579,8512,2018
Atlanta Hawks*,82,19880,3178,7155,.444,893,2502,.357,2285,4653,.491,1280,1658,.772,876,2722,3598,1919,738,424,1262,1768,8529,2018
Golden State Warriors*,82,19780,3181,7311,.435,737,2277,.324,2444,5034,.485,1450,1905,.761,963,2604,3567,1862,705,313,1272,1588,8549,2018
Los Angeles Clippers*,82,19755,3163,6999,.452,753,2154,.350,2410,4845,.497,1480,1917,.772,837,2700,3537,1891,577,258,1084,1835,8559,2018
Charlotte Hornets,82,19830,3237,7092,.456,950,2576,.369,2287,4516,.506,1161,1496,.776,732,2909,3641,2012,539,450,1071,1631,8585,2018
Indiana Pacers*,82,19855,3115,6909,.451,849,2389,.355,2266,4520,.501,1557,1974,.789,879,2751,3630,1832,661,407,1225,1599,8636,2018
Boston Celtics*,82,19755,3168,7035,.450,735,2213,.332,2433,4822,.505,1570,2042,.769,883,2769,3652,1851,623,425,1141,1664,8641,2018
Oklahoma City Thunder*,82,19805,3215,6998,.459,724,2036,.356,2491,4962,.502,1525,1996,.764,750,2583,3333,1758,698,450,1129,1697,8679,2018
New Orleans Pelicans,82,19905,3286,7299,.450,863,2445,.353,2423,4854,.499,1293,1697,.762,872,3091,3963,1921,603,348,1144,1581,8728,2018
Minnesota Timberwolves,82,19805,3246,6829,.475,811,2213,.366,2435,4616,.528,1445,1881,.768,806,2508,3314,1896,629,413,1169,1681,8748,2018
Sacramento Kings,82,19880,3153,6824,.462,896,2462,.364,2257,4362,.517,1546,1988,.778,826,2689,3515,1941,694,420,1145,1646,8748,2018
Cleveland Cavaliers*,82,19880,3333,7284,.458,850,2353,.361,2483,4931,.504,1271,1644,.773,902,2724,3626,2024,598,349,1033,1690,8787,2018
Washington Wizards*,82,19855,3253,6978,.466,810,2224,.364,2443,4754,.514,1489,1982,.751,868,2661,3529,1870,606,377,1257,1621,8805,2018
Orlando Magic,82,19805,3304,7081,.467,794,2161,.367,2510,4920,.510,1425,1860,.766,799,2934,3733,1936,622,419,1069,1532,8827,2018
New York Knicks,82,19855,3259,7163,.455,806,2313,.348,2453,4850,.506,1533,1988,.771,953,2715,3668,1786,615,377,1060,1516,8857,2018
Philadelphia 76ers,82,19830,3244,7043,.461,729,2044,.357,2515,4999,.503,1650,2135,.773,886,2802,3688,1859,704,446,1241,1610,8867,2018
Portland Trail Blazers*,82,19930,3213,7069,.455,762,2058,.370,2451,5011,.489,1706,2173,.785,830,2778,3608,1688,633,431,1052,1624,8894,2018
Houston Rockets*,82,19780,3375,7286,.463,820,2389,.343,2555,4897,.522,1415,1819,.778,878,2735,3613,1979,697,409,1235,1674,8985,2018
Denver Nuggets,82,19755,3454,7248,.477,808,2153,.375,2646,5095,.519,1403,1794,.782,770,2576,3346,1972,681,404,982,1653,9119,2018
Los Angeles Lakers,82,19705,3405,7053,.483,830,2245,.370,2575,4808,.536,1499,1966,.762,843,2801,3644,2110,698,440,1188,1520,9139,2018
Brooklyn Nets,82,19755,3414,7449,.458,816,2232,.366,2598,5217,.498,1581,2049,.772,902,2965,3867,1888,780,457,1092,1671,9225,2018
Phoenix Suns,82,19830,3300,7070,.467,825,2159,.382,2475,4911,.504,1868,2387,.783,840,2772,3612,1818,663,435,1222,1822,9293,2018
League Average,82,19813,3202,7004,.457,792,2214,.358,2410,4790,.503,1463,1895,.772,831,2737,3568,1855,632,389,1144,1632,8658,2018
Utah Jazz*,82,19755,3057,6804,.449,778,2131,.365,2279,4673,.488,1295,1680,.771,710,2702,3412,1636,678,380,1224,1683,8187,2019
San Antonio Spurs*,82,19730,3131,6911,.453,750,2154,.348,2381,4757,.501,1175,1549,.759,756,2731,3487,1786,622,318,1155,1619,8187,2019
Boston Celtics*,82,19805,3066,6973,.440,769,2270,.339,2297,4703,.488,1334,1748,.763,791,2804,3595,1744,594,364,1159,1571,8235,2019
Miami Heat*,82,19930,3090,6873,.450,785,2181,.360,2305,4692,.491,1476,1885,.783,744,2791,3535,1720,616,378,1160,1587,8441,2019
Portland Trail Blazers*,82,19755,3146,7042,.447,794,2179,.364,2352,4863,.484,1362,1803,.755,763,2755,3518,1655,602,418,1036,1564,8448,2019
Toronto Raptors*,82,19830,3149,7017,.449,731,2046,.357,2418,4971,.486,1489,1941,.767,806,2672,3478,1785,588,401,1176,1633,8518,2019
Houston Rockets*,82,19755,3244,7017,.462,829,2365,.351,2415,4652,.519,1201,1610,.746,710,2738,3448,1837,609,363,1194,1670,8518,2019
Detroit Pistons,82,19805,3206,6988,.459,908,2527,.359,2298,4461,.515,1201,1548,.776,756,2833,3589,2064,597,398,1215,1511,8521,2019
Indiana Pacers*,82,19755,3230,6953,.465,870,2496,.349,2360,4457,.530,1213,1602,.757,838,2686,3524,1905,577,428,1271,1514,8543,2019
Oklahoma City Thunder*,82,19830,3156,6885,.458,920,2507,.367,2236,4378,.511,1332,1733,.769,781,2676,3457,1911,630,377,1315,1750,8564,2019
Philadelphia 76ers*,82,19780,3120,7185,.434,829,2427,.342,2291,4758,.482,1566,2102,.745,818,2641,3459,1782,697,417,1173,1670,8635,2019
Dallas Mavericks,82,19805,3219,6870,.469,874,2411,.363,2345,4459,.526,1327,1754,.757,725,3027,3752,1929,594,369,1127,1604,8639,2019
Memphis Grizzlies,82,19705,3046,6587,.462,874,2377,.368,2172,4210,.516,1688,2196,.769,782,2703,3485,1816,662,421,1210,1674,8654,2019
Sacramento Kings,82,19755,3177,6759,.470,976,2586,.377,2201,4173,.527,1347,1760,.765,745,2843,3588,1939,636,389,1176,1422,8677,2019
Washington Wizards*,82,19855,3195,6918,.462,835,2393,.349,2360,4525,.522,1469,1931,.761,805,2682,3487,1831,641,383,1224,1639,8694,2019
Milwaukee Bucks*,82,19830,3209,6864,.468,829,2226,.372,2380,4638,.513,1509,1926,.783,817,2686,3503,1939,585,366,1279,1633,8756,2019
Minnesota Timberwolves*,82,19805,3298,6942,.475,890,2431,.366,2408,4511,.534,1311,1683,.779,803,2626,3429,1962,529,382,1239,1711,8797,2019
Golden State Warriors*,82,19730,3296,7380,.447,853,2392,.357,2443,4988,.490,1369,1807,.758,893,2592,3485,1934,717,301,1175,1516,8814,2019
Charlotte Hornets,82,19780,3370,7199,.468,926,2467,.375,2444,4732,.516,1187,1494,.795,692,2891,3583,2029,542,404,1112,1839,8853,2019
New York Knicks,82,19830,3233,7078,.457,917,2494,.368,2316,4584,.505,1475,1906,.774,838,2702,3540,1965,670,389,1096,1509,8858,2019
Orlando Magic,82,19730,3355,7176,.468,819,2260,.362,2536,4916,.516,1345,1741,.773,868,2892,3760,1998,639,402,1166,1556,8874,2019
Denver Nuggets,82,19880,3386,7113,.476,893,2364,.378,2493,4749,.525,1234,1671,.738,800,2613,3413,2028,654,391,1131,1699,8899,2019
Atlanta Hawks,82,19705,3336,7107,.469,949,2519,.377,2387,4588,.520,1301,1686,.772,841,2785,3626,2137,710,453,1238,1661,8922,2019
Los Angeles Clippers,82,19705,3298,7194,.458,881,2477,.356,2417,4717,.512,1457,1864,.782,871,2706,3577,2015,699,462,1154,1803,8934,2019
Los Angeles Lakers,82,19905,3366,7374,.456,855,2469,.346,2511,4905,.512,1402,1843,.761,840,2835,3675,1932,682,447,1170,1679,8989,2019
Cleveland Cavaliers*,82,19730,3429,7238,.474,956,2596,.368,2473,4642,.533,1200,1588,.756,812,2766,3578,2122,613,340,1105,1696,9014,2019
Chicago Bulls,82,19855,3360,7115,.472,990,2678,.370,2370,4437,.534,1307,1660,.787,691,3053,3744,2123,588,423,1112,1425,9017,2019
Brooklyn Nets,82,19855,3418,7334,.466,741,2010,.369,2677,5324,.503,1471,1921,.766,853,2981,3834,1782,630,450,1015,1615,9048,2019
New Orleans Pelicans*,82,19955,3423,7539,.454,891,2509,.355,2532,5030,.503,1317,1679,.784,887,2843,3730,1947,670,344,1186,1669,9054,2019
Phoenix Suns,82,19705,3426,7274,.471,895,2398,.373,2531,4876,.519,1543,2014,.766,855,2906,3761,1910,712,488,1099,1715,9290,2019
League Average,82,19795,3248,7057,.460,860,2378,.362,2388,4679,.510,1363,1778,.767,796,2772,3568,1905,633,395,1170,1628,8719,2019
Indiana Pacers*,82,19705,3177,7059,.450,932,2633,.354,2245,4426,.507,1298,1718,.756,862,2718,3580,2006,608,425,1284,1642,8584,2020
Miami Heat,82,19730,3141,7116,.441,973,2717,.358,2168,4399,.493,1432,1861,.769,831,2792,3623,1913,612,389,1159,1652,8687,2020
Memphis Grizzlies,82,19880,3083,6836,.451,951,2639,.360,2132,4197,.508,1586,2023,.784,781,2883,3664,1920,625,402,1249,1758,8703,2020
Utah Jazz*,82,19755,3276,7253,.452,806,2273,.355,2470,4980,.496,1372,1822,.753,733,2762,3495,1770,695,376,1136,1835,8730,2020
Orlando Magic*,82,19780,3274,7185,.456,858,2475,.347,2416,4710,.513,1336,1717,.778,739,2922,3661,1892,575,362,1064,1537,8742,2020
Denver Nuggets*,82,19730,3246,7084,.458,887,2618,.339,2359,4466,.528,1372,1822,.753,799,2685,3484,2016,610,407,1109,1675,8751,2020
Detroit Pistons*,82,19855,3271,6969,.469,786,2278,.345,2485,4691,.530,1470,1947,.755,747,2834,3581,1940,566,419,1153,1748,8798,2020
Boston Celtics*,82,19780,3239,7222,.448,944,2748,.344,2295,4474,.513,1430,1872,.764,852,2912,3764,1940,556,317,1197,1602,8852,2020
Toronto Raptors*,82,19880,3302,7352,.449,882,2559,.345,2420,4793,.505,1399,1829,.765,867,2804,3671,2012,622,368,1225,1683,8885,2020
Houston Rockets*,82,19830,3313,7106,.466,831,2444,.340,2482,4662,.532,1493,1944,.768,899,2825,3724,1929,607,369,1232,1640,8950,2020
Milwaukee Bucks*,82,19780,3322,7669,.433,1073,2976,.361,2249,4693,.479,1242,1694,.733,813,2902,3715,2031,557,395,1096,1653,8959,2020
San Antonio Spurs*,82,19805,3404,7354,.463,961,2678,.359,2443,4676,.522,1249,1654,.755,756,2844,3600,2025,589,332,999,1611,9018,2020
Dallas Mavericks,82,19780,3357,7315,.459,918,2667,.344,2439,4648,.525,1400,1802,.777,836,2840,3676,2011,643,368,1065,1905,9032,2020
Portland Trail Blazers*,82,19855,3371,7384,.457,878,2443,.359,2493,4941,.505,1438,1868,.770,842,2670,3512,1906,603,420,1014,1699,9058,2020
Oklahoma City Thunder*,82,19855,3343,7272,.460,922,2592,.356,2421,4680,.517,1500,1971,.761,811,2936,3747,2039,672,415,1372,1844,9108,2020
Golden State Warriors*,82,19805,3315,7471,.444,955,2753,.347,2360,4718,.500,1535,1987,.773,886,2750,3636,1989,630,295,1105,1601,9120,2020
Charlotte Hornets,82,19830,3436,7311,.470,992,2748,.361,2444,4563,.536,1307,1660,.787,825,2931,3756,2133,565,492,1109,1686,9171,2020
Brooklyn Nets*,82,19980,3460,7581,.456,848,2486,.341,2612,5095,.513,1442,1872,.770,902,2889,3791,1944,638,432,1104,1807,9210,2020
Philadelphia 76ers*,82,19805,3418,7506,.455,843,2464,.342,2575,5042,.511,1545,2011,.768,823,2743,3566,1917,634,336,1045,1816,9224,2020
Chicago Bulls,82,19905,3464,7316,.473,990,2709,.365,2474,4607,.537,1377,1805,.763,824,2984,3808,2094,600,473,1092,1534,9295,2020
Los Angeles Lakers,82,19780,3438,7610,.452,971,2784,.349,2467,4826,.511,1459,1862,.784,924,2918,3842,2053,683,421,1167,1706,9306,2020
New York Knicks,82,19780,3434,7352,.467,969,2673,.363,2465,4679,.527,1493,1948,.766,881,3016,3897,2098,607,458,1084,1708,9330,2020
Minnesota Timberwolves,82,19830,3452,7386,.467,1041,2752,.378,2411,4634,.520,1401,1827,.767,921,2822,3743,2145,539,455,1209,1795,9346,2020
Cleveland Cavaliers,82,19755,3539,7148,.495,984,2590,.380,2555,4558,.561,1293,1680,.770,782,2835,3617,2107,568,459,1022,1592,9355,2020
Los Angeles Clippers*,82,19830,3423,7490,.457,849,2477,.343,2574,5013,.513,1677,2159,.777,925,2826,3751,1976,677,498,1081,1969,9372,2020
Sacramento Kings,82,19730,3465,7430,.466,986,2837,.348,2479,4593,.540,1539,1998,.770,917,3015,3932,2024,618,420,1304,1753,9455,2020
New Orleans Pelicans,82,19755,3549,7610,.466,1006,2766,.364,2543,4844,.525,1471,1926,.764,898,2855,3753,2174,702,445,1113,1722,9575,2020
Phoenix Suns,82,19880,3482,7230,.482,912,2454,.372,2570,4776,.538,1705,2263,.753,971,2897,3868,2126,737,411,1285,1694,9581,2020
Washington Wizards,82,19930,3560,7424,.480,994,2689,.370,2566,4735,.542,1474,1895,.778,936,2939,3875,2151,631,378,1292,1741,9588,2020
Atlanta Hawks,82,19855,3508,7417,.473,1013,2820,.359,2495,4597,.543,1759,2321,.758,871,2904,3775,2202,810,448,1234,1817,9788,2020
League Average,82,19815,3369,7315,.461,932,2625,.355,2437,4691,.520,1450,1892,.766,848,2855,3704,2016,626,406,1154,1714,9119,2020
Charlotte Hornets,65,15750,2708,5690,.476,803,2279,.352,1905,3411,.558,907,1197,.758,711,2276,2987,1732,523,328,935,1337,7126,2021
Chicago Bulls,65,15675,2568,5364,.479,726,2057,.353,1842,3307,.557,1283,1691,.759,660,2299,2959,1653,530,384,1187,1246,7145,2021
Detroit Pistons,66,15965,2768,5764,.480,705,1952,.361,2063,3812,.541,1072,1379,.777,668,2204,2872,1625,543,369,923,1308,7313,2021
New York Knicks,66,15965,2631,5678,.463,877,2303,.381,1754,3375,.520,1270,1696,.749,632,2284,2916,1605,474,333,907,1305,7409,2021
Cleveland Cavaliers,65,15725,2851,5811,.491,804,2143,.375,2047,3668,.558,955,1245,.767,633,2154,2787,1699,613,412,844,1277,7461,2021
Golden State Warriors,65,15725,2743,5760,.476,879,2261,.389,1864,3499,.533,1113,1422,.783,661,2359,3020,1698,536,321,1016,1308,7478,2021
Minnesota Timberwolves,64,15560,2760,5786,.477,740,2040,.363,2020,3746,.539,1263,1613,.783,647,2383,3030,1560,499,355,992,1383,7523,2021
Los Angeles Lakers*,71,17090,2773,6187,.448,827,2373,.349,1946,3814,.510,1270,1626,.781,668,2333,3001,1662,585,263,1130,1544,7643,2021
Toronto Raptors*,72,17380,2721,6359,.428,943,2798,.337,1778,3561,.499,1284,1670,.769,786,2530,3316,1841,520,395,1212,1466,7669,2021
Boston Celtics*,72,17430,2764,6268,.441,851,2504,.340,1913,3764,.508,1350,1761,.767,743,2449,3192,1613,514,396,1097,1487,7729,2021
Oklahoma City Thunder*,72,17430,2937,6454,.455,814,2395,.340,2123,4059,.523,1119,1408,.795,754,2472,3226,1656,505,290,1024,1641,7807,2021
Utah Jazz*,72,17355,2930,6417,.457,790,2235,.353,2140,4182,.512,1185,1545,.767,688,2386,3074,1548,566,329,889,1501,7835,2021
Indiana Pacers*,73,17620,2883,6459,.446,837,2455,.341,2046,4004,.511,1243,1577,.788,757,2545,3302,1686,504,335,1071,1373,7846,2021
Orlando Magic*,73,17570,2949,6343,.465,893,2453,.364,2056,3890,.529,1114,1445,.771,660,2616,3276,1804,511,338,1065,1420,7905,2021
Philadelphia 76ers*,73,17595,2905,6275,.463,759,2148,.353,2146,4127,.520,1341,1786,.751,628,2426,3054,1661,510,294,1009,1493,7910,2021
Los Angeles Clippers*,72,17380,2846,6494,.438,886,2566,.345,1960,3928,.499,1335,1766,.756,771,2491,3262,1709,540,338,1013,1647,7913,2021
Milwaukee Bucks*,73,17595,2843,6862,.414,1020,2871,.355,1823,3991,.457,1221,1551,.787,693,2651,3344,1764,538,326,1030,1586,7927,2021
Miami Heat*,73,17745,2831,6326,.448,956,2753,.347,1875,3573,.525,1346,1720,.783,674,2431,3105,1794,545,302,1022,1584,7964,2021
Denver Nuggets*,73,17745,2919,6311,.463,885,2473,.358,2034,3838,.530,1247,1643,.759,736,2377,3113,1852,525,324,1041,1494,7970,2021
Atlanta Hawks,67,16280,2903,6078,.478,797,2194,.363,2106,3884,.542,1419,1839,.772,748,2402,3150,1674,600,428,1006,1404,8022,2021
Sacramento Kings,72,17455,2898,6158,.471,894,2506,.357,2004,3652,.549,1384,1752,.790,654,2481,3135,1791,557,304,1094,1404,8074,2021
Brooklyn Nets*,72,17480,2981,6688,.446,877,2505,.350,2104,4183,.503,1250,1625,.769,766,2541,3307,1630,554,379,919,1521,8089,2021
San Antonio Spurs,71,17215,3004,6402,.469,931,2493,.373,2073,3909,.530,1238,1594,.777,665,2551,3216,1825,486,308,937,1424,8177,2021
Houston Rockets*,72,17380,3045,6589,.462,880,2522,.349,2165,4067,.532,1299,1706,.761,803,2645,3448,1819,578,354,1163,1515,8269,2021
Phoenix Suns,73,17595,3011,6378,.472,848,2335,.363,2163,4043,.535,1408,1787,.788,664,2497,3161,1723,576,401,1139,1653,8278,2021
Memphis Grizzlies,73,17570,2964,6592,.450,942,2580,.365,2022,4012,.504,1430,1828,.782,756,2519,3275,1814,585,386,1080,1474,8300,2021
Dallas Mavericks*,75,18175,3143,6868,.458,919,2615,.351,2224,4253,.523,1200,1578,.760,782,2625,3407,1794,525,311,896,1601,8405,2021
New Orleans Pelicans,72,17430,3077,6611,.465,880,2438,.361,2197,4173,.526,1400,1775,.789,727,2501,3228,1763,615,348,1045,1519,8434,2021
Washington Wizards,72,17355,3104,6363,.488,896,2386,.376,2208,3977,.555,1470,1890,.778,753,2572,3325,1814,541,363,1163,1601,8574,2021
Portland Trail Blazers*,74,17835,3090,6781,.456,1003,2619,.383,2087,4162,.501,1410,1828,.771,852,2617,3469,1840,502,364,953,1488,8593,2021
League Average,71,17069,2885,6271,.460,862,2408,.358,2023,3862,.524,1261,1631,.773,711,2454,3165,1722,540,346,1027,1467,7893,2021
New York Knicks*,72,17430,2730,6209,.440,864,2565,.337,1866,3644,.512,1216,1598,.761,695,2478,3173,1696,472,391,918,1286,7540,2022
Los Angeles Lakers*,72,17455,2862,6221,.460,818,2321,.352,2044,3900,.524,1144,1475,.776,634,2392,3026,1776,593,327,1095,1530,7686,2022
Utah Jazz*,72,17355,2943,6581,.447,783,2293,.341,2160,4288,.504,1047,1364,.768,706,2362,3068,1604,554,282,827,1365,7716,2022
Los Angeles Clippers*,72,17280,2887,6223,.464,833,2341,.356,2054,3882,.529,1157,1489,.777,659,2307,2966,1650,510,304,925,1303,7764,2022
Miami Heat*,72,17380,2815,6137,.459,1027,2814,.365,1788,3323,.538,1122,1435,.782,684,2404,3088,1857,541,287,1085,1414,7779,2022
Philadelphia 76ers*,72,17430,2835,6259,.453,857,2378,.360,1978,3881,.510,1253,1640,.764,702,2388,3090,1694,521,335,1122,1509,7780,2022
Phoenix Suns*,72,17480,2916,6248,.467,836,2359,.354,2080,3889,.535,1213,1560,.778,674,2401,3075,1652,498,258,981,1294,7881,2022
Denver Nuggets*,72,17480,2883,6149,.469,934,2570,.363,1949,3579,.545,1229,1589,.773,652,2314,2966,1864,540,325,1014,1379,7929,2022
Dallas Mavericks*,72,17305,2885,6269,.460,925,2537,.365,1960,3732,.525,1238,1621,.764,704,2460,3164,1631,527,264,908,1446,7933,2022
Detroit Pistons,72,17430,2980,6260,.476,817,2260,.362,2163,4000,.541,1221,1607,.760,717,2475,3192,1785,578,419,1004,1469,7998,2022
Boston Celtics*,72,17380,2875,6191,.464,925,2473,.374,1950,3718,.524,1329,1692,.785,677,2382,3059,1732,531,334,1015,1389,8004,2022
Atlanta Hawks*,72,17405,2971,6418,.463,858,2460,.349,2113,3958,.534,1219,1519,.803,719,2352,3071,1754,557,363,886,1422,8019,2022
Charlotte Hornets,72,17355,2972,6346,.468,1042,2847,.366,1930,3499,.552,1034,1387,.745,766,2487,3253,1951,582,347,1062,1340,8020,2022
Chicago Bulls,72,17380,2983,6313,.473,829,2328,.356,2154,3985,.541,1238,1600,.774,624,2410,3034,1737,614,364,917,1277,8033,2022
Toronto Raptors,72,17305,2809,6099,.461,1001,2641,.379,1808,3458,.523,1426,1785,.799,720,2582,3302,1872,477,402,1161,1405,8045,2022
Memphis Grizzlies*,72,17405,2953,6387,.462,926,2526,.367,2027,3861,.525,1251,1588,.788,704,2515,3219,1827,552,377,1068,1318,8083,2022
Cleveland Cavaliers,72,17430,3024,6245,.484,893,2334,.383,2131,3911,.545,1143,1468,.779,712,2437,3149,1828,613,425,1033,1451,8084,2022
Golden State Warriors,72,17305,2897,6408,.452,891,2481,.359,2006,3927,.511,1426,1834,.778,769,2635,3404,1711,567,312,1083,1406,8111,2022
San Antonio Spurs,72,17480,3055,6469,.472,885,2350,.377,2170,4119,.527,1128,1489,.758,732,2681,3413,1784,454,369,949,1338,8123,2022
Orlando Magic,72,17330,3039,6456,.471,987,2649,.373,2052,3807,.539,1093,1390,.786,704,2706,3410,1874,548,384,917,1343,8158,2022
Brooklyn Nets*,72,17405,3017,6573,.459,951,2607,.365,2066,3966,.521,1228,1584,.775,753,2348,3101,1729,550,330,908,1361,8213,2022
Milwaukee Bucks*,72,17330,3052,6688,.456,1068,2778,.384,1984,3910,.507,1053,1350,.780,693,2435,3128,1804,507,348,947,1320,8225,2022
Portland Trail Blazers*,72,17305,3007,6355,.473,928,2494,.372,2079,3861,.538,1289,1638,.787,710,2558,3268,1794,440,333,892,1374,8231,2022
New Orleans Pelicans,72,17430,3016,6431,.469,1043,2745,.380,1973,3686,.535,1197,1516,.790,644,2366,3010,1866,555,426,961,1534,8272,2022
Indiana Pacers,72,17455,3076,6576,.468,828,2265,.366,2248,4311,.521,1325,1695,.782,813,2555,3368,1877,535,381,1066,1306,8305,2022
Oklahoma City Thunder,72,17355,3123,6603,.473,978,2688,.364,2145,3915,.548,1102,1426,.773,729,2663,3392,1856,647,378,942,1336,8326,2022
Houston Rockets,72,17305,3075,6411,.480,966,2532,.382,2109,3879,.544,1286,1642,.783,713,2713,3426,1855,611,378,1055,1388,8402,2022
Sacramento Kings,72,17305,3139,6438,.488,893,2349,.380,2246,4089,.549,1283,1631,.787,767,2489,3256,1823,545,336,988,1348,8454,2022
Minnesota Timberwolves,72,17405,3098,6426,.482,945,2412,.392,2153,4014,.536,1332,1695,.786,718,2579,3297,1932,550,398,1102,1432,8473,2022
Washington Wizards*,72,17405,3103,6594,.471,896,2425,.369,2207,4169,.529,1428,1828,.781,738,2580,3318,1762,587,348,1056,1586,8530,2022
League Average,72,17383,2967,6366,.466,914,2494,.367,2053,3872,.530,1222,1571,.778,708,2482,3190,1786,545,351,996,1389,8071,2022
Boston Celtics*,82,19905,3137,7221,.434,969,2860,.339,2168,4361,.497,1324,1692,.783,858,2727,3585,1773,618,376,1133,1592,8567,2023
Dallas Mavericks*,82,19755,3198,7001,.457,895,2635,.340,2303,4366,.527,1296,1689,.767,780,2799,3579,1925,575,300,1073,1645,8587,2023
Golden State Warriors*,82,19730,3111,7098,.438,1000,2948,.339,2111,4150,.509,1426,1880,.759,792,2705,3497,1875,649,317,1189,1474,8648,2023
Miami Heat*,82,19855,3078,6886,.447,1064,3138,.339,2014,3748,.537,1437,1845,.779,783,2634,3417,1908,608,330,1228,1686,8657,2023
Cleveland Cavaliers,82,19730,3236,7152,.452,960,2721,.353,2276,4431,.514,1233,1592,.774,858,2657,3515,1978,691,380,1101,1638,8665,2023
New York Knicks,82,19780,3154,7050,.447,1038,3032,.342,2116,4018,.527,1395,1826,.764,766,2812,3578,1982,572,379,1039,1671,8741,2023
Toronto Raptors*,82,19855,3197,6919,.462,1014,2861,.354,2183,4058,.538,1374,1742,.789,847,2764,3611,2076,549,416,1298,1563,8782,2023
Phoenix Suns*,82,19730,3216,7243,.444,953,2805,.340,2263,4438,.510,1416,1861,.761,863,2783,3646,1875,614,327,1206,1553,8801,2023
Philadelphia 76ers*,82,19805,3253,7097,.458,931,2692,.346,2322,4405,.527,1364,1773,.769,838,2784,3622,1932,542,379,1087,1594,8801,2023
Utah Jazz*,82,19730,3314,7318,.453,994,2837,.350,2320,4481,.518,1199,1581,.758,809,2599,3408,1917,636,352,982,1664,8821,2023
Los Angeles Clippers,82,19780,3343,7432,.450,958,2780,.345,2385,4652,.513,1244,1606,.775,984,2881,3865,1975,631,339,1113,1515,8888,2023
Memphis Grizzlies*,82,19780,3305,7269,.455,987,2828,.349,2318,4441,.522,1417,1837,.771,821,2706,3527,2047,588,496,1235,1625,9014,2023
New Orleans Pelicans*,82,19755,3301,7009,.471,1064,2913,.365,2237,4096,.546,1377,1753,.786,759,2666,3425,2039,605,391,1164,1681,9043,2023
Denver Nuggets*,82,19805,3367,7168,.470,971,2806,.346,2396,4362,.549,1349,1783,.757,795,2680,3475,2082,649,392,1051,1632,9054,2023
Oklahoma City Thunder,82,19805,3398,7421,.458,1118,3171,.353,2280,4250,.536,1256,1629,.771,906,3060,3966,2142,695,490,1085,1463,9170,2023
Washington Wizards,82,19830,3384,7287,.464,941,2607,.361,2443,4680,.522,1475,1828,.807,840,2786,3626,1941,598,344,972,1634,9184,2023
Chicago Bulls*,82,19730,3397,7170,.474,960,2620,.366,2437,4550,.536,1430,1799,.795,764,2777,3541,2049,584,410,1071,1489,9184,2023
Brooklyn Nets*,82,19755,3340,7395,.452,1026,2974,.345,2314,4421,.523,1488,1888,.788,926,2690,3616,1954,650,403,1088,1616,9194,2023
Milwaukee Bucks*,82,19755,3391,7431,.456,1186,3328,.356,2205,4103,.537,1227,1634,.751,812,2805,3617,2122,606,357,1070,1612,9195,2023
Orlando Magic,82,19780,3346,7300,.458,1082,2979,.363,2264,4321,.524,1429,1851,.772,852,3014,3866,2034,655,428,1079,1501,9203,2023
Atlanta Hawks*,82,19705,3435,7294,.471,1051,2888,.364,2384,4406,.541,1294,1634,.792,838,2758,3596,2085,576,367,1046,1668,9215,2023
Detroit Pistons,82,19780,3333,7051,.473,966,2668,.362,2367,4383,.540,1597,2056,.777,847,2946,3793,2061,606,427,1197,1625,9229,2023
San Antonio Spurs,82,19805,3482,7475,.466,992,2756,.360,2490,4719,.528,1313,1711,.767,933,2902,3835,1970,601,403,1131,1553,9269,2023
Minnesota Timberwolves*,82,19780,3298,7163,.460,1071,3062,.350,2227,4101,.543,1624,2081,.780,904,2858,3762,2149,593,397,1339,1715,9291,2023
Charlotte Hornets,82,19880,3444,7388,.466,1148,3170,.362,2296,4218,.544,1385,1815,.763,931,2920,3851,2169,617,377,1229,1609,9421,2023
Indiana Pacers,82,19880,3485,7212,.483,985,2645,.372,2500,4567,.547,1470,1845,.797,833,2702,3535,2058,664,401,1087,1575,9425,2023
Portland Trail Blazers,82,19730,3373,7045,.479,1129,3046,.371,2244,3999,.561,1564,2014,.777,800,2868,3668,2184,672,409,1150,1589,9439,2023
Los Angeles Lakers,82,19980,3491,7424,.470,1032,2935,.352,2459,4489,.548,1428,1911,.747,902,2920,3822,2154,684,338,1152,1647,9442,2023
Sacramento Kings,82,19805,3561,7429,.479,1065,2864,.372,2496,4565,.547,1306,1682,.776,866,2891,3757,2077,668,395,1106,1665,9493,2023
Houston Rockets,82,19755,3562,7374,.483,1048,2966,.353,2514,4408,.570,1520,1943,.782,915,2831,3746,2103,776,474,1155,1812,9692,2023
League Average,82,19792,3331,7224,.461,1020,2885,.354,2311,4340,.533,1389,1793,.775,847,2798,3645,2021,626,386,1129,1610,9071,2023
Cleveland Cavaliers*,82,19880,3201,6847,.468,924,2508,.368,2277,4339,.525,1438,1838,.782,801,2580,3381,1888,575,360,1284,1675,8764,2024
Miami Heat*,82,19805,3288,6822,.482,1077,2933,.367,2211,3889,.569,1350,1728,.781,729,2702,3431,2097,571,309,1288,1643,9003,2024
Philadelphia 76ers*,82,19880,3312,7005,.473,952,2735,.348,2360,4270,.553,1518,1943,.781,782,2593,3375,1986,540,380,1171,1607,9094,2024
Toronto Raptors,82,19805,3312,6752,.491,1001,2676,.374,2311,4076,.567,1508,1893,.797,757,2709,3466,2148,492,376,1367,1604,9133,2024
Boston Celtics*,82,19980,3425,7394,.463,954,2763,.345,2471,4631,.534,1332,1733,.769,799,2810,3609,1895,544,318,1040,1568,9136,2024
Phoenix Suns*,82,19780,3280,7044,.466,938,2628,.357,2342,4416,.530,1651,2101,.786,840,2676,3516,1915,588,327,1183,1629,9149,2024
Chicago Bulls,82,19905,3339,7142,.468,1086,3042,.357,2253,4100,.550,1406,1806,.779,791,2763,3554,2131,546,389,1234,1537,9170,2024
Denver Nuggets*,82,19755,3423,7166,.478,933,2711,.344,2490,4455,.559,1443,1861,.775,832,2516,3348,2105,646,344,1105,1601,9222,2024
New Orleans Pelicans,82,19855,3357,7105,.472,1002,2953,.339,2355,4152,.567,1507,1935,.779,792,2634,3426,2044,600,386,1228,1673,9223,2024
Brooklyn Nets*,82,19730,3360,7257,.463,968,2640,.367,2392,4617,.518,1537,2003,.767,943,2758,3701,1916,575,317,1126,1517,9225,2024
Memphis Grizzlies*,82,19780,3340,7365,.453,1065,2998,.355,2275,4367,.521,1519,1931,.787,902,2738,3640,2167,559,427,1240,1644,9264,2024
Los Angeles Clippers*,82,19830,3430,7243,.474,1000,2738,.365,2430,4505,.539,1413,1832,.771,838,2699,3537,2048,640,343,1065,1607,9273,2024
New York Knicks*,82,19955,3343,7229,.462,1068,2992,.357,2275,4237,.537,1520,1943,.782,830,2617,3447,2062,496,370,1044,1694,9274,2024
Milwaukee Bucks*,82,19830,3483,7644,.456,991,2799,.354,2492,4845,.514,1334,1719,.776,879,2744,3623,1963,578,323,970,1557,9291,2024
Orlando Magic,82,19780,3389,7127,.476,1064,3030,.351,2325,4097,.567,1504,1890,.796,779,2669,3448,2122,634,415,1204,1681,9346,2024
Dallas Mavericks,82,19930,3425,7065,.485,913,2596,.352,2512,4469,.562,1597,2046,.781,830,2838,3668,2044,522,312,1075,1789,9360,2024
Washington Wizards,82,19755,3481,7363,.473,984,2688,.366,2497,4675,.534,1432,1794,.798,883,2645,3528,2035,581,406,1008,1590,9378,2024
Minnesota Timberwolves*,82,19830,3428,7277,.471,1007,2728,.369,2421,4549,.532,1634,2133,.766,928,2734,3662,2051,674,336,1262,1654,9497,2024
Oklahoma City Thunder,82,19855,3437,7252,.474,1059,2955,.358,2378,4297,.553,1611,2090,.771,982,2841,3823,2126,572,454,1375,1675,9544,2024
Los Angeles Lakers*,82,19880,3607,7698,.469,1028,2991,.344,2579,4707,.548,1319,1706,.773,908,2770,3678,2104,624,416,1035,1760,9561,2024
Golden State Warriors*,82,19830,3478,7423,.469,1060,2915,.364,2418,4508,.536,1589,2067,.769,880,2673,3553,2110,646,326,1172,1510,9605,2024
Charlotte Hornets,82,19830,3522,7391,.477,1004,2812,.357,2518,4579,.550,1562,1965,.795,895,2892,3787,2127,573,471,1177,1667,9610,2024
Portland Trail Blazers,82,19730,3522,7176,.491,1029,2717,.379,2493,4459,.559,1555,1977,.787,857,2686,3543,2214,640,352,1108,1679,9628,2024
Utah Jazz,82,19805,3555,7515,.473,1023,2830,.361,2532,4685,.540,1544,1989,.776,919,2644,3563,2047,639,405,1030,1679,9677,2024
Sacramento Kings*,82,19830,3589,7288,.492,1022,2740,.373,2567,4548,.564,1481,1882,.787,795,2665,3460,2187,598,341,1165,1711,9681,2024
Atlanta Hawks*,82,19855,3592,7398,.486,979,2748,.356,2613,4650,.562,1524,1899,.803,866,2751,3617,2131,616,414,1162,1612,9687,2024
Detroit Pistons,82,19805,3533,7222,.489,984,2732,.360,2549,4490,.568,1669,2149,.777,901,2767,3668,2112,631,453,1108,1718,9719,2024
Houston Rockets,82,19755,3480,7226,.482,1189,3183,.374,2291,4043,.567,1576,1986,.794,861,2543,3404,2143,718,509,1079,1692,9725,2024
Indiana Pacers,82,19755,3549,7323,.485,1019,2733,.373,2530,4590,.551,1679,2100,.800,993,2721,3714,2163,650,438,1235,1660,9796,2024
San Antonio Spurs,82,19855,3780,7460,.507,1036,2651,.391,2744,4809,.571,1496,1942,.770,877,2811,3688,2198,665,431,1135,1516,10092,2024
League Average,82,19828,3442,7241,.475,1012,2806,.361,2430,4435,.548,1508,1929,.782,856,2706,3562,2076,598,382,1156,1638,9404,2024
Minnesota Timberwolves*,82,19805,3198,7114,.450,937,2645,.354,2261,4469,.506,1402,1794,.781,843,2555,3398,2008,616,371,1166,1630,8735,2025
New York Knicks*,82,19730,3304,7026,.470,1028,2813,.365,2276,4213,.540,1237,1620,.764,839,2492,3331,2098,552,431,1082,1565,8873,2025
Miami Heat*,82,19755,3297,7056,.467,1064,3018,.353,2233,4038,.553,1230,1577,.780,757,2750,3507,2173,543,388,1126,1550,8888,2025
Orlando Magic*,82,19780,3264,6884,.474,945,2636,.358,2319,4248,.546,1419,1819,.780,731,2537,3268,1958,666,379,1234,1710,8892,2025
Boston Celtics*,82,19830,3403,7515,.453,1059,3008,.352,2344,4507,.520,1092,1422,.768,907,2645,3552,2042,510,304,986,1416,8957,2025
Denver Nuggets*,82,19705,3332,7210,.462,919,2587,.355,2413,4623,.522,1404,1819,.772,894,2573,3467,2108,578,394,1014,1467,8987,2025
Cleveland Cavaliers*,82,19805,3323,7176,.463,1029,2773,.371,2294,4403,.521,1363,1724,.791,823,2676,3499,2071,632,411,1115,1536,9038,2025
New Orleans Pelicans*,82,19705,3317,7155,.464,1109,3176,.349,2208,3979,.555,1331,1699,.783,826,2644,3470,2196,536,424,1168,1507,9074,2025
Philadelphia 76ers*,82,19780,3322,7098,.468,979,2765,.354,2343,4333,.541,1524,1926,.791,903,2742,3645,2143,506,503,1201,1519,9147,2025
Los Angeles Clippers*,82,19705,3413,7288,.468,1054,2902,.363,2359,4386,.538,1332,1718,.775,909,2551,3460,2165,597,384,1069,1537,9212,2025
Oklahoma City Thunder*,82,19805,3328,7322,.455,1101,3052,.361,2227,4270,.522,1482,1878,.789,968,2695,3663,2207,582,419,1287,1548,9239,2025
Memphis Grizzlies,82,19780,3381,7128,.474,1098,2905,.378,2283,4223,.541,1391,1785,.779,874,2867,3741,2179,668,536,1239,1539,9251,2025
Phoenix Suns*,82,19780,3444,7428,.464,1074,2949,.364,2370,4479,.529,1319,1705,.774,898,2490,3388,2155,685,372,1043,1612,9281,2025
Houston Rockets,82,19855,3344,7226,.463,1012,2904,.348,2332,4322,.540,1583,2065,.767,878,2803,3681,1997,597,482,1132,1609,9283,2025
Brooklyn Nets,82,19805,3410,7255,.470,1066,2865,.372,2344,4390,.534,1401,1736,.807,843,2788,3631,2088,563,409,1035,1496,9287,2025
Chicago Bulls,82,19980,3370,7131,.473,1196,3235,.370,2174,3896,.558,1388,1789,.776,829,2729,3558,2287,555,404,1147,1538,9324,2025
Sacramento Kings,82,19855,3414,7114,.480,1074,2775,.387,2340,4339,.539,1513,1892,.800,747,2740,3487,2208,606,370,1139,1504,9415,2025
Golden State Warriors,82,19830,3453,7415,.466,1088,3030,.359,2365,4385,.539,1449,1840,.788,892,2627,3519,2187,633,407,1067,1471,9443,2025
Portland Trail Blazers,82,19880,3485,7104,.491,957,2730,.351,2528,4374,.578,1535,1938,.792,868,2726,3594,2225,729,528,1173,1467,9462,2025
Dallas Mavericks*,82,19705,3522,7413,.475,1075,2921,.368,2447,4492,.545,1364,1772,.770,896,2800,3696,2258,603,331,1127,1667,9483,2025
Milwaukee Bucks*,82,19805,3543,7537,.470,1032,2897,.356,2511,4640,.541,1423,1764,.807,843,2765,3608,2169,580,347,986,1576,9541,2025
Charlotte Hornets,82,19730,3555,7191,.494,1118,2965,.377,2437,4226,.577,1352,1699,.796,867,2853,3720,2356,582,396,1117,1432,9580,2025
Los Angeles Lakers*,82,19855,3643,7687,.474,1170,3109,.376,2473,4578,.540,1174,1476,.795,893,2719,3612,2316,673,390,1100,1619,9630,2025
San Antonio Spurs,82,19830,3684,7570,.487,1040,2791,.373,2644,4779,.553,1316,1679,.784,860,2857,3717,2296,733,380,1098,1470,9724,2025
Toronto Raptors,82,19805,3669,7476,.491,1120,2979,.376,2549,4497,.567,1283,1627,.789,919,2785,3704,2346,595,474,1137,1487,9741,2025
Detroit Pistons,82,19755,3578,7301,.490,991,2682,.370,2587,4619,.560,1610,2013,.800,791,2745,3536,2216,727,490,1019,1457,9757,2025
Indiana Pacers*,82,19705,3653,7361,.496,877,2404,.365,2776,4957,.560,1677,2130,.787,901,2654,3555,2020,543,440,1142,1501,9860,2025
Atlanta Hawks,82,19855,3659,7394,.495,1147,2987,.384,2512,4407,.570,1417,1790,.792,870,2758,3628,2314,638,461,1158,1594,9882,2025
Utah Jazz,82,19805,3654,7509,.487,1213,3070,.395,2441,4439,.550,1364,1768,.771,900,2564,3464,2442,704,528,1009,1577,9885,2025
Washington Wizards,82,19730,3777,7618,.496,1007,2782,.362,2770,4836,.573,1528,1966,.777,993,3020,4013,2382,655,496,1152,1473,10089,2025
League Average,82,19792,3458,7290,.474,1053,2879,.366,2405,4412,.545,1397,1781,.784,865,2705,3570,2187,613,422,1116,1536,9365,2025
